struct_elem,sw_part,start1,end1,start2,end2,start3,end3,type
1103,1.023552905575332,1055,2158,0,0,0,0,1
1092,1.023552905575332,1066,2158,0,0,0,0,1
402,1.023552905575332,1070,1472,0,0,0,0,1
857,1.023552905575332,1061,1918,0,0,0,0,1
401,1.023552905575332,1082,1483,0,0,0,0,1
1817,1.023552905575332,358,2175,0,0,0,0,1
1806,1.023552905575332,369,2175,0,0,0,0,1
754,1.023552905575332,388,1142,0,0,0,0,1
402,1.023552905575332,1071,1473,0,0,0,0,1
1349,1.023552905575332,830,2179,0,0,0,0,1
1819,1.023552905575332,362,2181,0,0,0,0,1
844,1.023552905575332,1076,1920,0,0,0,0,1
853,1.023552905575332,1076,1929,0,0,0,0,1
1099,1.023552905575332,818,1917,0,0,0,0,1
1801,1.023552905575332,369,2170,0,0,0,0,1
1348,1.023552905575332,821,2169,0,0,0,0,1
1826,1.023552905575332,366,2192,0,0,0,0,1
750,1.023552905575332,377,1127,0,0,0,0,1
1801,1.023552905575332,370,2171,0,0,0,0,1
813,1.023552905575332,394,1207,0,0,0,0,1
1825,1.023552905575332,351,2176,0,0,0,0,1
1357,1.023552905575332,822,2179,0,0,0,0,1
1823,1.023552905575332,362,2185,0,0,0,0,1
389,1.023552905575332,1078,1467,0,0,0,0,1
1462,2.685214529255432,21,1483,0,0,0,0,1
408,1.023552905575332,1066,1474,0,0,0,0,1
852,1.023552905575332,1068,1920,0,0,0,0,1
1821,1.023552905575332,365,2186,0,0,0,0,1
408,1.023552905575332,1067,1475,0,0,0,0,1
400,1.023552905575332,1073,1473,0,0,0,0,1
1816,1.023552905575332,358,2174,0,0,0,0,1
1805,1.023552905575332,369,2174,0,0,0,0,1
1352,1.023552905575332,821,2173,0,0,0,0,1
843,1.023552905575332,1075,1918,0,0,0,0,1
1805,1.023552905575332,370,2175,0,0,0,0,1
381,1.023552905575332,1074,1455,0,0,0,0,1
762,1.023552905575332,380,1142,0,0,0,0,1
1386,1.023552905575332,112,1498,0,0,0,0,1
382,1.023552905575332,1089,1471,0,0,0,0,1
1825,1.023552905575332,364,2189,0,0,0,0,1
1816,1.023552905575332,365,2181,0,0,0,0,1
1442,1.023552905575332,32,1474,0,0,0,0,1
1825,1.023552905575332,365,2190,0,0,0,0,1
1451,1.023552905575332,32,1483,0,0,0,0,1
384,1.023552905575332,1084,1468,0,0,0,0,1
1800,1.023552905575332,369,2169,0,0,0,0,1
1347,1.023552905575332,821,2168,0,0,0,0,1
404,1.023552905575332,1073,1477,0,0,0,0,1
1356,1.023552905575332,821,2177,0,0,0,0,1
384,1.023552905575332,1085,1469,0,0,0,0,1
812,1.023552905575332,394,1206,0,0,0,0,1
856,1.023552905575332,1075,1931,0,0,0,0,1
748,1.023552905575332,380,1128,0,0,0,0,1
759,1.023552905575332,383,1142,0,0,0,0,1
1461,2.192203519468242,21,1482,0,0,0,0,1
407,1.023552905575332,1066,1473,0,0,0,0,1
851,1.023552905575332,1068,1919,0,0,0,0,1
1100,1.023552905575332,1057,2157,0,0,0,0,1
382,1.023552905575332,1088,1470,0,0,0,0,1
406,1.023552905575332,1069,1475,0,0,0,0,1
1820,1.023552905575332,365,2185,0,0,0,0,1
1446,1.023552905575332,32,1478,0,0,0,0,1
386,1.023552905575332,1081,1467,0,0,0,0,1
390,1.023552905575332,1073,1463,0,0,0,0,1
849,1.023552905575332,1071,1920,0,0,0,0,1
1342,1.023552905575332,821,2163,0,0,0,0,1
399,1.023552905575332,1073,1472,0,0,0,0,1
1804,1.023552905575332,369,2173,0,0,0,0,1
1351,1.023552905575332,821,2172,0,0,0,0,1
1803,1.023552905575332,372,2175,0,0,0,0,1
851,1.023552905575332,1075,1926,0,0,0,0,1
1813,1.023552905575332,361,2174,0,0,0,0,1
756,1.023552905575332,372,1128,0,0,0,0,1
1113,1.023552905575332,1056,2169,0,0,0,0,1
1805,1.023552905575332,376,2181,0,0,0,0,1
1450,1.023552905575332,31,1481,0,0,0,0,1
1802,1.023552905575332,373,2175,0,0,0,0,1
379,1.023552905575332,1091,1470,0,0,0,0,1
394,1.023552905575332,1072,1466,0,0,0,0,1
403,1.023552905575332,1072,1475,0,0,0,0,1
1351,1.023552905575332,828,2179,0,0,0,0,1
1450,1.023552905575332,32,1482,0,0,0,0,1
1097,1.023552905575332,1061,2158,0,0,0,0,1
390,1.023552905575332,1081,1471,0,0,0,0,1
755,1.023552905575332,373,1128,0,0,0,0,1
394,1.023552905575332,1073,1467,0,0,0,0,1
383,1.023552905575332,1084,1467,0,0,0,0,1
1095,1.023552905575332,820,1915,0,0,0,0,1
403,1.023552905575332,1073,1476,0,0,0,0,1
1447,1.023552905575332,46,1493,0,0,0,0,1
837,1.023552905575332,1075,1912,0,0,0,0,1
846,1.023552905575332,1075,1921,0,0,0,0,1
1099,1.023552905575332,1056,2155,0,0,0,0,1
855,1.023552905575332,1075,1930,0,0,0,0,1
405,1.023552905575332,1068,1473,0,0,0,0,1
1364,1.023552905575332,813,2177,0,0,0,0,1
758,1.023552905575332,383,1141,0,0,0,0,1
1099,1.023552905575332,1057,2156,0,0,0,0,1
381,1.023552905575332,1088,1469,0,0,0,0,1
385,1.023552905575332,1080,1465,0,0,0,0,1
405,1.023552905575332,1069,1474,0,0,0,0,1
848,1.023552905575332,1070,1918,0,0,0,0,1
1810,1.023552905575332,365,2175,0,0,0,0,1
1445,1.023552905575332,32,1477,0,0,0,0,1
1345,1.023552905575332,831,2176,0,0,0,0,1
389,1.023552905575332,1073,1462,0,0,0,0,1
848,1.023552905575332,1071,1919,0,0,0,0,1
387,1.023552905575332,1084,1471,0,0,0,0,1
1442,1.023552905575332,46,1488,0,0,0,0,1
1103,1.023552905575332,812,1915,0,0,0,0,1
755,1.023552905575332,371,1126,0,0,0,0,1
855,1.023552905575332,1074,1929,0,0,0,0,1
1112,1.023552905575332,1056,2168,0,0,0,0,1
818,1.023552905575332,389,1207,0,0,0,0,1
1382,1.023552905575332,114,1496,0,0,0,0,1
389,1.023552905575332,1080,1469,0,0,0,0,1
1101,1.023552905575332,816,1917,0,0,0,0,1
1822,1.023552905575332,367,2189,0,0,0,0,1
393,1.023552905575332,1072,1465,0,0,0,0,1
1467,1.023552905575332,31,1498,0,0,0,0,1
402,1.023552905575332,1072,1474,0,0,0,0,1
1804,1.023552905575332,368,2172,0,0,0,0,1
1797,1.023552905575332,371,2168,0,0,0,0,1
393,1.023552905575332,1073,1466,0,0,0,0,1
382,1.023552905575332,1084,1466,0,0,0,0,1
387,1.023552905575332,1083,1470,0,0,0,0,1
1446,1.023552905575332,46,1492,0,0,0,0,1
1350,1.023552905575332,820,2170,0,0,0,0,1
1359,1.023552905575332,820,2179,0,0,0,0,1
853,1.023552905575332,1077,1930,0,0,0,0,1
1098,1.023552905575332,1056,2154,0,0,0,0,1
391,1.023552905575332,1076,1467,0,0,0,0,1
380,1.023552905575332,1087,1467,0,0,0,0,1
1107,1.023552905575332,1056,2163,0,0,0,0,1
854,1.023552905575332,1066,1920,0,0,0,0,1
404,1.023552905575332,1068,1472,0,0,0,0,1
1099,1.023552905575332,819,1918,0,0,0,0,1
1096,1.023552905575332,816,1912,0,0,0,0,1
1092,1.023552905575332,1067,2159,0,0,0,0,1
404,1.023552905575332,1069,1473,0,0,0,0,1
1826,1.023552905575332,367,2193,0,0,0,0,1
733,1.023552905575332,394,1127,0,0,0,0,1
1808,1.023552905575332,368,2176,0,0,0,0,1
750,1.023552905575332,378,1128,0,0,0,0,1
1801,1.023552905575332,371,2172,0,0,0,0,1
382,1.023552905575332,1083,1465,0,0,0,0,1
1441,1.023552905575332,46,1487,0,0,0,0,1
1450,1.023552905575332,46,1496,0,0,0,0,1
754,1.023552905575332,371,1125,0,0,0,0,1
1819,1.023552905575332,363,2182,0,0,0,0,1
1102,1.023552905575332,1056,2158,0,0,0,0,1
845,1.023552905575332,1074,1919,0,0,0,0,1
384,1.023552905575332,1087,1471,0,0,0,0,1
388,1.023552905575332,1079,1467,0,0,0,0,1
1350,1.023552905575332,819,2169,0,0,0,0,1
1465,1.023552905575332,33,1498,0,0,0,0,1
1381,1.023552905575332,114,1495,0,0,0,0,1
1816,1.023552905575332,359,2175,0,0,0,0,1
851,1.023552905575332,1070,1921,0,0,0,0,1
815,1.023552905575332,392,1207,0,0,0,0,1
1348,1.023552905575332,831,2179,0,0,0,0,1
386,1.023552905575332,1083,1469,0,0,0,0,1
1445,1.023552905575332,46,1491,0,0,0,0,1
1349,1.023552905575332,820,2169,0,0,0,0,1
843,1.023552905575332,1077,1920,0,0,0,0,1
1815,1.023552905575332,360,2175,0,0,0,0,1
852,1.023552905575332,1077,1929,0,0,0,0,1
379,1.023552905575332,1087,1466,0,0,0,0,1
761,1.023552905575332,381,1142,0,0,0,0,1
1823,1.023552905575332,363,2186,0,0,0,0,1
1102,1.023552905575332,1055,2157,0,0,0,0,1
378,1.023552905575332,1090,1468,0,0,0,0,1
1098,1.023552905575332,819,1917,0,0,0,0,1
1350,1.023552905575332,827,2177,0,0,0,0,1
1095,1.023552905575332,816,1911,0,0,0,0,1
1091,1.023552905575332,1067,2158,0,0,0,0,1
401,1.023552905575332,1071,1472,0,0,0,0,1
1800,1.023552905575332,371,2171,0,0,0,0,1
1348,1.023552905575332,830,2178,0,0,0,0,1
753,1.023552905575332,389,1142,0,0,0,0,1
1827,1.023552905575332,362,2189,0,0,0,0,1
758,1.023552905575332,370,1128,0,0,0,0,1
1818,1.023552905575332,363,2181,0,0,0,0,1
387,1.023552905575332,1079,1466,0,0,0,0,1
1444,1.023552905575332,44,1488,0,0,0,0,1
405,1.023552905575332,1070,1475,0,0,0,0,1
1815,1.023552905575332,359,2174,0,0,0,0,1
1358,1.023552905575332,819,2177,0,0,0,0,1
1825,1.023552905575332,366,2191,0,0,0,0,1
814,1.023552905575332,392,1206,0,0,0,0,1
1800,1.023552905575332,370,2170,0,0,0,0,1
385,1.023552905575332,1083,1468,0,0,0,0,1
1824,1.023552905575332,351,2175,0,0,0,0,1
1813,1.023552905575332,362,2175,0,0,0,0,1
842,1.023552905575332,1077,1919,0,0,0,0,1
1385,1.023552905575332,113,1498,0,0,0,0,1
851,1.023552905575332,1077,1928,0,0,0,0,1
1813,1.023552905575332,363,2176,0,0,0,0,1
1822,1.023552905575332,363,2185,0,0,0,0,1
1101,1.023552905575332,1055,2156,0,0,0,0,1
1450,1.023552905575332,33,1483,0,0,0,0,1
407,1.023552905575332,1067,1474,0,0,0,0,1
851,1.023552905575332,1069,1920,0,0,0,0,1
1344,1.023552905575332,819,2163,0,0,0,0,1
1353,1.023552905575332,819,2172,0,0,0,0,1
1820,1.023552905575332,366,2186,0,0,0,0,1
739,2.260214143010031,378,1117,0,0,0,0,1
1804,1.023552905575332,370,2174,0,0,0,0,1
1347,1.023552905575332,830,2177,0,0,0,0,1
1105,1.023552905575332,1054,2159,0,0,0,0,1
398,1.023552905575332,1074,1472,0,0,0,0,1
381,1.023552905575332,1089,1470,0,0,0,0,1
1817,1.023552905575332,363,2180,0,0,0,0,1
750,1.023552905575332,392,1142,0,0,0,0,1
381,1.023552905575332,1090,1471,0,0,0,0,1
1824,1.023552905575332,365,2189,0,0,0,0,1
1443,1.023552905575332,44,1487,0,0,0,0,1
1097,1.023552905575332,818,1915,0,0,0,0,1
404,1.023552905575332,1070,1474,0,0,0,0,1
848,1.023552905575332,1072,1920,0,0,0,0,1
1824,1.023552905575332,366,2190,0,0,0,0,1
1355,1.023552905575332,821,2176,0,0,0,0,1
1799,1.023552905575332,370,2169,0,0,0,0,1
811,1.023552905575332,394,1205,0,0,0,0,1
1812,1.023552905575332,362,2174,0,0,0,0,1
1355,1.023552905575332,822,2177,0,0,0,0,1
393,1.023552905575332,1074,1467,0,0,0,0,1
387,1.023552905575332,1078,1465,0,0,0,0,1
850,1.023552905575332,1068,1918,0,0,0,0,1
855,1.023552905575332,1076,1931,0,0,0,0,1
1100,1.023552905575332,1055,2155,0,0,0,0,1
758,1.023552905575332,384,1142,0,0,0,0,1
1449,1.023552905575332,33,1482,0,0,0,0,1
406,1.023552905575332,1067,1473,0,0,0,0,1
1094,1.023552905575332,821,1915,0,0,0,0,1
1105,1.023552905575332,1053,2158,0,0,0,0,1
1803,1.023552905575332,369,2172,0,0,0,0,1
1819,1.023552905575332,366,2185,0,0,0,0,1
1350,1.023552905575332,821,2171,0,0,0,0,1
407,1.023552905575332,1073,1480,0,0,0,0,1
1827,1.023552905575332,351,2178,0,0,0,0,1
1419,1.9818337011489937,63,1482,0,0,0,0,1
1104,1.023552905575332,1054,2158,0,0,0,0,1
1384,1.023552905575332,112,1496,0,0,0,0,1
391,1.023552905575332,1078,1469,0,0,0,0,1
1112,1.023552905575332,1057,2169,0,0,0,0,1
1818,1.023552905575332,357,2175,0,0,0,0,1
1449,1.023552905575332,32,1481,0,0,0,0,1
403,1.023552905575332,1070,1473,0,0,0,0,1
402,1.023552905575332,1073,1475,0,0,0,0,1
1818,1.023552905575332,358,2176,0,0,0,0,1
1350,1.023552905575332,829,2179,0,0,0,0,1
1823,1.023552905575332,366,2189,0,0,0,0,1
1354,1.023552905575332,821,2175,0,0,0,0,1
1798,1.023552905575332,370,2168,0,0,0,0,1
810,1.023552905575332,394,1204,0,0,0,0,1
845,1.023552905575332,1075,1920,0,0,0,0,1
854,1.023552905575332,1075,1929,0,0,0,0,1
1446,1.023552905575332,29,1475,0,0,0,0,1
1799,1.023552905575332,376,2175,0,0,0,0,1
757,1.023552905575332,383,1140,0,0,0,0,1
1827,1.023552905575332,364,2191,0,0,0,0,1
854,1.023552905575332,1076,1930,0,0,0,0,1
752,1.023552905575332,376,1128,0,0,0,0,1
1818,1.023552905575332,365,2183,0,0,0,0,1
1444,1.023552905575332,32,1476,0,0,0,0,1
1100,1.023552905575332,818,1918,0,0,0,0,1
388,1.023552905575332,1073,1461,0,0,0,0,1
386,1.023552905575332,1084,1470,0,0,0,0,1
1349,1.023552905575332,821,2170,0,0,0,0,1
1358,1.023552905575332,821,2179,0,0,0,0,1
755,1.023552905575332,387,1142,0,0,0,0,1
751,1.023552905575332,377,1128,0,0,0,0,1
1102,1.023552905575332,813,1915,0,0,0,0,1
1820,1.023552905575332,361,2181,0,0,0,0,1
1822,1.023552905575332,364,2186,0,0,0,0,1
1813,1.023552905575332,365,2178,0,0,0,0,1
401,1.023552905575332,1072,1473,0,0,0,0,1
1822,1.023552905575332,365,2187,0,0,0,0,1
1448,1.023552905575332,32,1480,0,0,0,0,1
388,1.023552905575332,1081,1469,0,0,0,0,1
392,1.023552905575332,1073,1465,0,0,0,0,1
1466,1.023552905575332,32,1498,0,0,0,0,1
401,1.023552905575332,1073,1474,0,0,0,0,1
1353,1.023552905575332,821,2174,0,0,0,0,1
752,1.023552905575332,390,1142,0,0,0,0,1
844,1.023552905575332,1075,1919,0,0,0,0,1
1387,1.023552905575332,111,1498,0,0,0,0,1
1106,1.023552905575332,1056,2162,0,0,0,0,1
1347,1.023552905575332,832,2179,0,0,0,0,1
1824,1.023552905575332,361,2185,0,0,0,0,1
401,1.023552905575332,1079,1480,0,0,0,0,1
1826,1.023552905575332,364,2190,0,0,0,0,1
1452,1.023552905575332,31,1483,0,0,0,0,1
853,1.023552905575332,1067,1920,0,0,0,0,1
756,1.023552905575332,384,1140,0,0,0,0,1
1817,1.023552905575332,365,2182,0,0,0,0,1
1443,1.023552905575332,32,1475,0,0,0,0,1
1807,1.023552905575332,368,2175,0,0,0,0,1
1805,1.023552905575332,379,2184,0,0,0,0,1
396,1.023552905575332,1073,1469,0,0,0,0,1
385,1.023552905575332,1084,1469,0,0,0,0,1
1440,1.023552905575332,46,1486,0,0,0,0,1
749,1.023552905575332,379,1128,0,0,0,0,1
1353,1.023552905575332,820,2173,0,0,0,0,1
754,1.023552905575332,387,1141,0,0,0,0,1
1101,1.023552905575332,1056,2157,0,0,0,0,1
383,1.023552905575332,1087,1470,0,0,0,0,1
407,1.023552905575332,1068,1475,0,0,0,0,1
1366,1.023552905575332,813,2179,0,0,0,0,1
1821,1.023552905575332,364,2185,0,0,0,0,1
1101,1.023552905575332,1057,2158,0,0,0,0,1
383,1.023552905575332,1088,1471,0,0,0,0,1
387,1.023552905575332,1080,1467,0,0,0,0,1
1099,1.023552905575332,816,1915,0,0,0,0,1
391,1.023552905575332,1072,1463,0,0,0,0,1
850,1.023552905575332,1070,1920,0,0,0,0,1
400,1.023552905575332,1072,1472,0,0,0,0,1
1802,1.023552905575332,368,2170,0,0,0,0,1
382,1.023552905575332,1073,1455,0,0,0,0,1
1804,1.023552905575332,371,2175,0,0,0,0,1
1347,1.023552905575332,831,2178,0,0,0,0,1
391,1.023552905575332,1073,1464,0,0,0,0,1
1357,1.023552905575332,820,2177,0,0,0,0,1
757,1.023552905575332,371,1128,0,0,0,0,1
1814,1.023552905575332,361,2175,0,0,0,0,1
1349,1.023552905575332,827,2176,0,0,0,0,1
760,1.023552905575332,382,1142,0,0,0,0,1
852,1.023552905575332,1067,1919,0,0,0,0,1
1384,1.023552905575332,114,1498,0,0,0,0,1
391,1.023552905575332,1080,1471,0,0,0,0,1
380,1.023552905575332,1091,1471,0,0,0,0,1
1103,1.023552905575332,816,1919,0,0,0,0,1
1824,1.023552905575332,367,2191,0,0,0,0,1
395,1.023552905575332,1072,1467,0,0,0,0,1
1806,1.023552905575332,368,2174,0,0,0,0,1
1799,1.023552905575332,371,2170,0,0,0,0,1
1439,1.023552905575332,46,1485,0,0,0,0,1
1448,1.023552905575332,46,1494,0,0,0,0,1
748,1.023552905575332,379,1127,0,0,0,0,1
1352,1.023552905575332,820,2172,0,0,0,0,1
753,1.023552905575332,387,1140,0,0,0,0,1
1100,1.023552905575332,1056,2156,0,0,0,0,1
393,1.023552905575332,1076,1469,0,0,0,0,1
382,1.023552905575332,1087,1469,0,0,0,0,1
1826,1.023552905575332,363,2189,0,0,0,0,1
852,1.023552905575332,1074,1926,0,0,0,0,1
386,1.023552905575332,1079,1465,0,0,0,0,1
406,1.023552905575332,1068,1474,0,0,0,0,1
1379,1.023552905575332,114,1493,0,0,0,0,1
386,1.023552905575332,1080,1466,0,0,0,0,1
1357,1.023552905575332,819,2176,0,0,0,0,1
1819,1.023552905575332,367,2186,0,0,0,0,1
390,1.023552905575332,1072,1462,0,0,0,0,1
849,1.023552905575332,1070,1919,0,0,0,0,1
735,1.023552905575332,394,1129,0,0,0,0,1
1801,1.023552905575332,368,2169,0,0,0,0,1
813,1.023552905575332,392,1205,0,0,0,0,1
1803,1.023552905575332,371,2174,0,0,0,0,1
1346,1.023552905575332,831,2177,0,0,0,0,1
1098,1.023552905575332,1060,2158,0,0,0,0,1
384,1.023552905575332,1083,1467,0,0,0,0,1
1443,1.023552905575332,46,1489,0,0,0,0,1
1452,1.023552905575332,46,1498,0,0,0,0,1
841,1.023552905575332,1077,1918,0,0,0,0,1
1356,1.023552905575332,820,2176,0,0,0,0,1
850,1.023552905575332,1077,1927,0,0,0,0,1
379,1.023552905575332,1076,1455,0,0,0,0,1
1812,1.023552905575332,363,2175,0,0,0,0,1
856,1.023552905575332,1074,1930,0,0,0,0,1
390,1.023552905575332,1079,1469,0,0,0,0,1
1096,1.023552905575332,819,1915,0,0,0,0,1
1447,1.023552905575332,44,1491,0,0,0,0,1
754,1.023552905575332,374,1128,0,0,0,0,1
398,1.023552905575332,1082,1480,0,0,0,0,1
851,1.023552905575332,1067,1918,0,0,0,0,1
1102,1.023552905575332,816,1918,0,0,0,0,1
1823,1.023552905575332,367,2190,0,0,0,0,1
1805,1.023552905575332,368,2173,0,0,0,0,1
748,1.023552905575332,394,1142,0,0,0,0,1
1798,1.023552905575332,371,2169,0,0,0,0,1
1438,1.023552905575332,46,1484,0,0,0,0,1
738,2.783591130182374,379,1117,0,0,0,0,1
1106,1.023552905575332,1052,2158,0,0,0,0,1
388,1.023552905575332,1083,1471,0,0,0,0,1
854,1.023552905575332,1077,1931,0,0,0,0,1
1445,1.023552905575332,30,1475,0,0,0,0,1
381,1.023552905575332,1087,1468,0,0,0,0,1
1104,1.023552905575332,1055,2159,0,0,0,0,1
380,1.023552905575332,1090,1470,0,0,0,0,1
1442,1.023552905575332,44,1486,0,0,0,0,1
1352,1.023552905575332,827,2179,0,0,0,0,1
1818,1.023552905575332,367,2185,0,0,0,0,1
734,1.023552905575332,394,1128,0,0,0,0,1
1442,1.023552905575332,45,1487,0,0,0,0,1
847,1.023552905575332,1073,1920,0,0,0,0,1
383,1.023552905575332,1083,1466,0,0,0,0,1
1820,1.023552905575332,362,2182,0,0,0,0,1
1383,1.023552905575332,113,1496,0,0,0,0,1
849,1.023552905575332,1077,1926,0,0,0,0,1
1811,1.023552905575332,363,2174,0,0,0,0,1
1820,1.023552905575332,363,2183,0,0,0,0,1
846,1.023552905575332,1074,1920,0,0,0,0,1
1099,1.023552905575332,1055,2154,0,0,0,0,1
1448,1.023552905575332,33,1481,0,0,0,0,1
405,1.023552905575332,1067,1472,0,0,0,0,1
758,1.023552905575332,382,1140,0,0,0,0,1
816,1.023552905575332,391,1207,0,0,0,0,1
1351,1.023552905575332,819,2170,0,0,0,0,1
1360,1.023552905575332,819,2179,0,0,0,0,1
1827,1.023552905575332,366,2193,0,0,0,0,1
1446,1.023552905575332,45,1491,0,0,0,0,1
1802,1.023552905575332,370,2172,0,0,0,0,1
835,1.023552905575332,1077,1912,0,0,0,0,1
1824,1.023552905575332,362,2186,0,0,0,0,1
844,1.023552905575332,1077,1921,0,0,0,0,1
1103,1.023552905575332,1054,2157,0,0,0,0,1
379,1.023552905575332,1089,1468,0,0,0,0,1
409,1.023552905575332,1066,1475,0,0,0,0,1
1815,1.023552905575332,363,2178,0,0,0,0,1
