struct_elem,sw_part,start1,end1,start2,end2,start3,end3,type
1432,1.023552905575332,2252,3684,0,0,0,0,1
3699,1.023552905575332,1132,4831,0,0,0,0,1
3688,1.023552905575332,1143,4831,0,0,0,0,1
2887,1.023552905575332,668,3555,0,0,0,0,1
3563,1.023552905575332,1217,4780,0,0,0,0,1
1532,0.09113304067924481,1999,3531,0,0,0,0,1
3789,0.008968687248165047,1089,4878,0,0,0,0,1
2035,1.023552905575332,1076,3111,0,0,0,0,1
3771,1.023552905575332,1090,4861,0,0,0,0,1
2850,1.023552905575332,669,3519,0,0,0,0,1
1348,1.023552905575332,2310,3658,0,0,0,0,1
1136,1.023552905575332,2419,3555,0,0,0,0,1
3698,1.023552905575332,1133,4831,0,0,0,0,1
3641,1.023552905575332,1157,4798,0,0,0,0,1
1117,1.023552905575332,2413,3530,0,0,0,0,1
3457,1.023552905575332,1238,4695,0,0,0,0,1
3601,1.023552905575332,1180,4781,0,0,0,0,1
3457,1.023552905575332,1239,4696,0,0,0,0,1
3856,1.023552905575332,1013,4869,0,0,0,0,1
3710,1.023552905575332,1110,4820,0,0,0,0,1
1174,1.023552905575332,2381,3555,0,0,0,0,1
1115,1.023552905575332,2416,3531,0,0,0,0,1
3632,1.023552905575332,1163,4795,0,0,0,0,1
3766,1.023552905575332,1089,4855,0,0,0,0,1
3641,1.023552905575332,1163,4804,0,0,0,0,1
3455,1.023552905575332,1242,4697,0,0,0,0,1
2032,1.023552905575332,1079,3111,0,0,0,0,1
3751,1.023552905575332,1109,4860,0,0,0,0,1
3766,1.023552905575332,1090,4856,0,0,0,0,1
3708,1.023552905575332,1113,4821,0,0,0,0,1
1170,1.023552905575332,2389,3559,0,0,0,0,1
3348,0.0494779402984859,1090,4438,0,0,0,0,1
2450,1.023552905575332,1071,3521,0,0,0,0,1
3708,1.023552905575332,1114,4822,0,0,0,0,1
3649,1.023552905575332,1149,4798,0,0,0,0,1
3638,1.023552905575332,1160,4798,0,0,0,0,1
3749,1.023552905575332,1112,4861,0,0,0,0,1
1996,1.023552905575332,1114,3110,0,0,0,0,1
3535,1.023552905575332,1217,4752,0,0,0,0,1
1169,1.023552905575332,2381,3550,0,0,0,0,1
3636,1.023552905575332,1163,4799,0,0,0,0,1
3562,1.023552905575332,1217,4779,0,0,0,0,1
2886,1.023552905575332,668,3554,0,0,0,0,1
1649,1.023552905575332,1946,3595,0,0,0,0,1
2436,1.023552905575332,1079,3515,0,0,0,0,1
3815,1.023552905575332,1015,4830,0,0,0,0,1
1263,1.023552905575332,2331,3594,0,0,0,0,1
2849,1.023552905575332,669,3518,0,0,0,0,1
1262,1.023552905575332,2334,3596,0,0,0,0,1
1240,1.023552905575332,2356,3596,0,0,0,0,1
1249,1.023552905575332,2356,3605,0,0,0,0,1
1135,1.023552905575332,2419,3554,0,0,0,0,1
1648,1.023552905575332,1947,3595,0,0,0,0,1
1114,1.023552905575332,2415,3529,0,0,0,0,1
3666,1.023552905575332,1132,4798,0,0,0,0,1
1173,1.023552905575332,2381,3554,0,0,0,0,1
1114,1.023552905575332,2416,3530,0,0,0,0,1
1093,1.023552905575332,2439,3532,0,0,0,0,1
3772,1.023552905575332,1086,4858,0,0,0,0,1
3640,1.023552905575332,1163,4803,0,0,0,0,1
1140,1.023552905575332,2418,3558,0,0,0,0,1
3774,1.023552905575332,1089,4863,0,0,0,0,1
3454,1.023552905575332,1242,4696,0,0,0,0,1
3665,1.023552905575332,1133,4798,0,0,0,0,1
3748,1.023552905575332,1112,4860,0,0,0,0,1
3776,1.023552905575332,1085,4861,0,0,0,0,1
3534,1.023552905575332,1217,4751,0,0,0,0,1
3855,1.023552905575332,1012,4867,0,0,0,0,1
3646,1.023552905575332,1152,4798,0,0,0,0,1
3635,1.023552905575332,1163,4798,0,0,0,0,1
3686,1.023552905575332,1143,4829,0,0,0,0,1
1135,1.023552905575332,2418,3553,0,0,0,0,1
3769,1.023552905575332,1089,4858,0,0,0,0,1
3237,1.023552905575332,1152,4389,0,0,0,0,1
1429,1.023552905575332,2255,3684,0,0,0,0,1
3449,1.023552905575332,1242,4691,0,0,0,0,1
1221,1.023552905575332,2356,3577,0,0,0,0,1
1032,1.023552905575332,2425,3457,0,0,0,0,1
3351,0.046524386999369574,1090,4441,0,0,0,0,1
1173,1.023552905575332,2380,3553,0,0,0,0,1
1239,1.023552905575332,2356,3595,0,0,0,0,1
1134,1.023552905575332,2419,3553,0,0,0,0,1
1999,1.023552905575332,1113,3112,0,0,0,0,1
1113,1.023552905575332,2415,3528,0,0,0,0,1
2444,1.023552905575332,1104,3548,0,0,0,0,1
1172,1.023552905575332,2381,3553,0,0,0,0,1
2436,1.023552905575332,1078,3514,0,0,0,0,1
1240,1.023552905575332,2363,3603,0,0,0,0,1
3453,1.023552905575332,1241,4694,0,0,0,0,1
3713,1.023552905575332,1109,4822,0,0,0,0,1
1139,1.023552905575332,2418,3557,0,0,0,0,1
3769,1.023552905575332,1088,4857,0,0,0,0,1
3748,1.023552905575332,1111,4859,0,0,0,0,1
1371,1.023552905575332,2286,3657,0,0,0,0,1
1350,1.023552905575332,2309,3659,0,0,0,0,1
3234,1.023552905575332,1155,4389,0,0,0,0,1
3453,1.023552905575332,1242,4695,0,0,0,0,1
1223,1.023552905575332,2353,3576,0,0,0,0,1
1111,1.023552905575332,2419,3530,0,0,0,0,1
3711,1.023552905575332,1112,4823,0,0,0,0,1
1177,1.023552905575332,2380,3557,0,0,0,0,1
1999,1.023552905575332,1112,3111,0,0,0,0,1
1117,1.023552905575332,2415,3532,0,0,0,0,1
3775,1.023552905575332,1085,4860,0,0,0,0,1
1428,1.023552905575332,2254,3682,0,0,0,0,1
1267,1.023552905575332,2329,3596,0,0,0,0,1
1143,1.023552905575332,2418,3561,0,0,0,0,1
3236,1.023552905575332,1152,4388,0,0,0,0,1
1428,1.023552905575332,2255,3683,0,0,0,0,1
3565,1.023552905575332,1216,4781,0,0,0,0,1
3773,1.023552905575332,1088,4861,0,0,0,0,1
1109,1.023552905575332,2422,3531,0,0,0,0,1
1220,1.023552905575332,2356,3576,0,0,0,0,1
3685,1.023552905575332,1135,4820,0,0,0,0,1
1172,1.023552905575332,2380,3552,0,0,0,0,1
3694,1.023552905575332,1135,4829,0,0,0,0,1
1238,1.023552905575332,2356,3594,0,0,0,0,1
3745,1.023552905575332,1115,4860,0,0,0,0,1
1111,1.023552905575332,2418,3529,0,0,0,0,1
1320,1.023552905575332,2338,3658,0,0,0,0,1
1264,1.023552905575332,2332,3596,0,0,0,0,1
3768,1.023552905575332,1088,4856,0,0,0,0,1
1320,1.023552905575332,2339,3659,0,0,0,0,1
3233,1.023552905575332,1155,4388,0,0,0,0,1
3662,1.023552905575332,1135,4797,0,0,0,0,1
2886,1.023552905575332,670,3556,0,0,0,0,1
2868,1.023552905575332,703,3571,0,0,0,0,1
3710,1.023552905575332,1112,4822,0,0,0,0,1
1199,1.023552905575332,2378,3577,0,0,0,0,1
1347,1.023552905575332,2312,3659,0,0,0,0,1
3639,1.023552905575332,1161,4800,0,0,0,0,1
1998,1.023552905575332,1112,3110,0,0,0,0,1
3565,1.023552905575332,1215,4780,0,0,0,0,1
1106,1.023552905575332,2418,3524,0,0,0,0,1
1427,1.023552905575332,2254,3681,0,0,0,0,1
3772,1.023552905575332,1087,4859,0,0,0,0,1
3852,1.023552905575332,1015,4867,0,0,0,0,1
1138,1.023552905575332,2417,3555,0,0,0,0,1
2886,1.023552905575332,669,3555,0,0,0,0,1
1219,1.023552905575332,2356,3575,0,0,0,0,1
1028,1.023552905575332,2427,3455,0,0,0,0,1
1176,1.023552905575332,2379,3555,0,0,0,0,1
1117,1.023552905575332,2414,3531,0,0,0,0,1
3634,1.023552905575332,1161,4795,0,0,0,0,1
1067,1.023552905575332,2389,3456,0,0,0,0,1
3643,1.023552905575332,1161,4804,0,0,0,0,1
2450,1.023552905575332,1106,3556,0,0,0,0,1
3457,1.023552905575332,1240,4697,0,0,0,0,1
2034,1.023552905575332,1077,3111,0,0,0,0,1
1319,1.023552905575332,2338,3657,0,0,0,0,1
1283,1.023552905575332,2339,3622,0,0,0,0,1
3661,1.023552905575332,1134,4795,0,0,0,0,1
3619,1.023552905575332,1154,4773,0,0,0,0,1
1243,1.023552905575332,2362,3605,0,0,0,0,1
3767,1.023552905575332,1088,4855,0,0,0,0,1
1319,1.023552905575332,2339,3658,0,0,0,0,1
1188,1.023552905575332,2389,3577,0,0,0,0,1
3793,1.023552905575332,1090,4883,0,0,0,0,1
3661,1.023552905575332,1135,4796,0,0,0,0,1
3638,1.023552905575332,1161,4799,0,0,0,0,1
3564,1.023552905575332,1215,4779,0,0,0,0,1
1105,1.023552905575332,2418,3523,0,0,0,0,1
3648,1.023552905575332,1150,4798,0,0,0,0,1
1095,0.008735977236051806,2436,3531,0,0,0,0,1
3771,1.023552905575332,1087,4858,0,0,0,0,1
3536,1.023552905575332,1216,4752,0,0,0,0,1
1431,1.023552905575332,2253,3684,0,0,0,0,1
1251,1.023552905575332,2354,3605,0,0,0,0,1
1650,1.023552905575332,1945,3595,0,0,0,0,1
2449,1.023552905575332,1072,3521,0,0,0,0,1
3707,1.023552905575332,1115,4822,0,0,0,0,1
1175,1.023552905575332,2378,3553,0,0,0,0,1
2885,1.023552905575332,669,3554,0,0,0,0,1
3748,1.023552905575332,1113,4861,0,0,0,0,1
1116,1.023552905575332,2413,3529,0,0,0,0,1
3714,1.023552905575332,1117,4831,0,0,0,0,1
3600,1.023552905575332,1180,4780,0,0,0,0,1
1027,1.023552905575332,2427,3454,0,0,0,0,1
1116,1.023552905575332,2414,3530,0,0,0,0,1
2440,1.023552905575332,1106,3546,0,0,0,0,1
3456,1.023552905575332,1240,4696,0,0,0,0,1
3855,1.023552905575332,1014,4869,0,0,0,0,1
3709,1.023552905575332,1111,4820,0,0,0,0,1
1318,1.023552905575332,2338,3656,0,0,0,0,1
3792,1.023552905575332,1089,4881,0,0,0,0,1
3618,1.023552905575332,1154,4772,0,0,0,0,1
3765,1.023552905575332,1090,4855,0,0,0,0,1
1169,1.023552905575332,2389,3558,0,0,0,0,1
3695,1.023552905575332,1136,4831,0,0,0,0,1
3778,1.023552905575332,1082,4860,0,0,0,0,1
1196,1.023552905575332,2389,3585,0,0,0,0,1
3707,1.023552905575332,1114,4821,0,0,0,0,1
1995,1.023552905575332,1114,3109,0,0,0,0,1
3637,1.023552905575332,1161,4798,0,0,0,0,1
3777,1.023552905575332,1083,4860,0,0,0,0,1
1322,1.023552905575332,2337,3659,0,0,0,0,1
2435,1.023552905575332,1079,3514,0,0,0,0,1
1223,1.023552905575332,2354,3577,0,0,0,0,1
1430,1.023552905575332,2253,3683,0,0,0,0,1
3664,1.023552905575332,1134,4798,0,0,0,0,1
1111,1.023552905575332,2420,3531,0,0,0,0,1
2848,1.023552905575332,669,3517,0,0,0,0,1
1136,1.023552905575332,2417,3553,0,0,0,0,1
2448,1.023552905575332,1072,3520,0,0,0,0,1
3540,1.023552905575332,1214,4754,0,0,0,0,1
1174,1.023552905575332,2378,3552,0,0,0,0,1
1507,0.09745327636257327,2025,3532,0,0,0,0,1
3747,1.023552905575332,1113,4860,0,0,0,0,1
3513,1.023552905575332,1215,4728,0,0,0,0,1
1647,1.023552905575332,1947,3594,0,0,0,0,1
3599,1.023552905575332,1180,4779,0,0,0,0,1
3567,1.023552905575332,1214,4781,0,0,0,0,1
1248,1.023552905575332,2357,3605,0,0,0,0,1
2889,1.023552905575332,667,3556,0,0,0,0,1
2442,1.023552905575332,1294,3736,0,0,0,0,1
3645,1.023552905575332,1153,4798,0,0,0,0,1
1113,1.023552905575332,2416,3529,0,0,0,0,1
1092,1.023552905575332,2439,3531,0,0,0,0,1
3771,1.023552905575332,1086,4857,0,0,0,0,1
3236,1.023552905575332,1153,4389,0,0,0,0,1
3773,1.023552905575332,1089,4862,0,0,0,0,1
3455,1.023552905575332,1240,4695,0,0,0,0,1
3854,1.023552905575332,1014,4868,0,0,0,0,1
3666,1.023552905575332,1163,4829,0,0,0,0,1
1168,1.023552905575332,2389,3557,0,0,0,0,1
2852,1.023552905575332,669,3521,0,0,0,0,1
1218,1.023552905575332,2387,3605,0,0,0,0,1
1178,1.023552905575332,2378,3556,0,0,0,0,1
3706,1.023552905575332,1114,4820,0,0,0,0,1
3459,1.023552905575332,1238,4697,0,0,0,0,1
3813,1.023552905575332,1014,4827,0,0,0,0,1
3712,1.023552905575332,1110,4822,0,0,0,0,1
3634,1.023552905575332,1163,4797,0,0,0,0,1
3775,1.023552905575332,1086,4861,0,0,0,0,1
3768,1.023552905575332,1089,4857,0,0,0,0,1
2434,1.023552905575332,1079,3513,0,0,0,0,1
1110,1.023552905575332,2420,3530,0,0,0,0,1
3768,1.023552905575332,1090,4858,0,0,0,0,1
3710,1.023552905575332,1113,4823,0,0,0,0,1
1172,1.023552905575332,2389,3561,0,0,0,0,1
1031,1.023552905575332,2425,3456,0,0,0,0,1
1247,1.023552905575332,2356,3603,0,0,0,0,1
1173,1.023552905575332,2378,3551,0,0,0,0,1
3377,0.09382623434633404,1090,4467,0,0,0,0,1
1998,1.023552905575332,1113,3111,0,0,0,0,1
1031,1.023552905575332,2426,3457,0,0,0,0,1
1108,1.023552905575332,2423,3531,0,0,0,0,1
1998,1.023552905575332,1114,3112,0,0,0,0,1
1266,1.023552905575332,2330,3596,0,0,0,0,1
2852,1.023552905575332,668,3520,0,0,0,0,1
3817,1.023552905575332,1014,4831,0,0,0,0,1
3537,1.023552905575332,1217,4754,0,0,0,0,1
2036,1.023552905575332,1075,3111,0,0,0,0,1
3744,1.023552905575332,1116,4860,0,0,0,0,1
1069,1.023552905575332,2388,3457,0,0,0,0,1
3770,1.023552905575332,1086,4856,0,0,0,0,1
1112,1.023552905575332,2416,3528,0,0,0,0,1
3564,1.023552905575332,1217,4781,0,0,0,0,1
2888,1.023552905575332,668,3556,0,0,0,0,1
3452,1.023552905575332,1242,4694,0,0,0,0,1
1190,1.023552905575332,2387,3577,0,0,0,0,1
3642,1.023552905575332,1156,4798,0,0,0,0,1
2851,1.023552905575332,669,3520,0,0,0,0,1
1110,1.023552905575332,2419,3529,0,0,0,0,1
1349,1.023552905575332,2310,3659,0,0,0,0,1
1176,1.023552905575332,2380,3556,0,0,0,0,1
1242,1.023552905575332,2356,3598,0,0,0,0,1
3458,1.023552905575332,1238,4696,0,0,0,0,1
1116,1.023552905575332,2415,3531,0,0,0,0,1
1175,1.023552905575332,2381,3556,0,0,0,0,1
1116,1.023552905575332,2416,3532,0,0,0,0,1
3633,1.023552905575332,1163,4796,0,0,0,0,1
3752,1.023552905575332,1108,4860,0,0,0,0,1
3456,1.023552905575332,1241,4697,0,0,0,0,1
1133,1.023552905575332,2418,3551,0,0,0,0,1
3767,1.023552905575332,1089,4856,0,0,0,0,1
3642,1.023552905575332,1163,4805,0,0,0,0,1
3349,0.08336824439451725,1089,4438,0,0,0,0,1
1427,1.023552905575332,2255,3682,0,0,0,0,1
3564,1.023552905575332,1216,4780,0,0,0,0,1
3709,1.023552905575332,1113,4822,0,0,0,0,1
1171,1.023552905575332,2380,3551,0,0,0,0,1
1997,1.023552905575332,1113,3110,0,0,0,0,1
1030,1.023552905575332,2426,3456,0,0,0,0,1
3663,1.023552905575332,1132,4795,0,0,0,0,1
3621,1.023552905575332,1152,4773,0,0,0,0,1
3816,1.023552905575332,1014,4830,0,0,0,0,1
3536,1.023552905575332,1217,4753,0,0,0,0,1
3769,1.023552905575332,1086,4855,0,0,0,0,1
3857,1.023552905575332,1012,4869,0,0,0,0,1
3711,1.023552905575332,1109,4820,0,0,0,0,1
3637,1.023552905575332,1163,4800,0,0,0,0,1
1137,1.023552905575332,2418,3555,0,0,0,0,1
1263,1.023552905575332,2333,3596,0,0,0,0,1
2885,1.023552905575332,670,3555,0,0,0,0,1
1221,1.023552905575332,2353,3574,0,0,0,0,1
1198,1.023552905575332,2387,3585,0,0,0,0,1
3709,1.023552905575332,1112,4821,0,0,0,0,1
1175,1.023552905575332,2380,3555,0,0,0,0,1
3780,1.023552905575332,1081,4861,0,0,0,0,1
1346,1.023552905575332,2312,3658,0,0,0,0,1
1115,1.023552905575332,2415,3530,0,0,0,0,1
3773,1.023552905575332,1085,4858,0,0,0,0,1
3715,1.023552905575332,1108,4823,0,0,0,0,1
1426,1.023552905575332,2254,3680,0,0,0,0,1
1242,1.023552905575332,2363,3605,0,0,0,0,1
3455,1.023552905575332,1241,4696,0,0,0,0,1
1132,1.023552905575332,2418,3550,0,0,0,0,1
3563,1.023552905575332,1216,4779,0,0,0,0,1
3771,1.023552905575332,1088,4859,0,0,0,0,1
3750,1.023552905575332,1111,4861,0,0,0,0,1
3716,1.023552905575332,1115,4831,0,0,0,0,1
1218,1.023552905575332,2356,3574,0,0,0,0,1
1029,1.023552905575332,2425,3454,0,0,0,0,1
1170,1.023552905575332,2380,3550,0,0,0,0,1
1113,1.023552905575332,2419,3532,0,0,0,0,1
3715,1.023552905575332,1116,4831,0,0,0,0,1
1109,1.023552905575332,2418,3527,0,0,0,0,1
1430,1.023552905575332,2254,3684,0,0,0,0,1
1136,1.023552905575332,2418,3554,0,0,0,0,1
2033,1.023552905575332,1078,3111,0,0,0,0,1
3741,1.023552905575332,1119,4860,0,0,0,0,1
3352,0.08292014063517282,1089,4441,0,0,0,0,1
1318,1.023552905575332,2339,3657,0,0,0,0,1
3660,1.023552905575332,1135,4795,0,0,0,0,1
2884,1.023552905575332,670,3554,0,0,0,0,1
1174,1.023552905575332,2380,3554,0,0,0,0,1
3696,1.023552905575332,1135,4831,0,0,0,0,1
3779,1.023552905575332,1081,4860,0,0,0,0,1
1345,1.023552905575332,2312,3657,0,0,0,0,1
3714,1.023552905575332,1108,4822,0,0,0,0,1
3770,1.023552905575332,1087,4857,0,0,0,0,1
3454,1.023552905575332,1241,4695,0,0,0,0,1
1091,1.023552905575332,2441,3532,0,0,0,0,1
3770,1.023552905575332,1088,4858,0,0,0,0,1
3749,1.023552905575332,1111,4860,0,0,0,0,1
1224,1.023552905575332,2353,3577,0,0,0,0,1
2448,1.023552905575332,1073,3521,0,0,0,0,1
1536,0.05339888450826657,1996,3532,0,0,0,0,1
1115,1.023552905575332,2414,3529,0,0,0,0,1
2439,1.023552905575332,1106,3545,0,0,0,0,1
2000,1.023552905575332,1112,3112,0,0,0,0,1
3713,1.023552905575332,1118,4831,0,0,0,0,1
1429,1.023552905575332,2254,3683,0,0,0,0,1
3774,1.023552905575332,1087,4861,0,0,0,0,1
3617,1.023552905575332,1154,4771,0,0,0,0,1
1241,1.023552905575332,2362,3603,0,0,0,0,1
2032,1.023552905575332,1078,3110,0,0,0,0,1
3854,1.023552905575332,1015,4869,0,0,0,0,1
1186,1.023552905575332,2389,3575,0,0,0,0,1
3644,1.023552905575332,1154,4798,0,0,0,0,1
3791,1.023552905575332,1090,4881,0,0,0,0,1
3235,1.023552905575332,1154,4389,0,0,0,0,1
1119,1.023552905575332,2413,3532,0,0,0,0,1
1247,1.023552905575332,2358,3605,0,0,0,0,1
1030,1.023552905575332,2427,3457,0,0,0,0,1
1344,1.023552905575332,2312,3656,0,0,0,0,1
1321,1.023552905575332,2337,3658,0,0,0,0,1
3769,1.023552905575332,1087,4856,0,0,0,0,1
3712,1.023552905575332,1111,4823,0,0,0,0,1
1321,1.023552905575332,2338,3659,0,0,0,0,1
1429,1.023552905575332,2253,3682,0,0,0,0,1
3621,1.023552905575332,1154,4775,0,0,0,0,1
1249,1.023552905575332,2354,3603,0,0,0,0,1
1222,1.023552905575332,2355,3577,0,0,0,0,1
3663,1.023552905575332,1135,4798,0,0,0,0,1
1110,1.023552905575332,2421,3531,0,0,0,0,1
3746,1.023552905575332,1113,4859,0,0,0,0,1
1348,1.023552905575332,2311,3659,0,0,0,0,1
1071,1.023552905575332,2385,3456,0,0,0,0,1
3566,1.023552905575332,1214,4780,0,0,0,0,1
1025,1.023552905575332,2427,3452,0,0,0,0,1
3539,1.023552905575332,1215,4754,0,0,0,0,1
1535,0.08994956140682313,1996,3531,0,0,0,0,1
1114,1.023552905575332,2414,3528,0,0,0,0,1
2434,1.023552905575332,1114,3548,0,0,0,0,1
3566,1.023552905575332,1215,4781,0,0,0,0,1
3818,1.023552905575332,1012,4830,0,0,0,0,1
3235,1.023552905575332,1153,4388,0,0,0,0,1
3454,1.023552905575332,1240,4694,0,0,0,0,1
1107,1.023552905575332,2418,3525,0,0,0,0,1
3853,1.023552905575332,1014,4867,0,0,0,0,1
3712,1.023552905575332,1119,4831,0,0,0,0,1
1533,0.05242322015588042,1999,3532,0,0,0,0,1
3773,1.023552905575332,1087,4860,0,0,0,0,1
3690,1.023552905575332,1141,4831,0,0,0,0,1
1112,1.023552905575332,2417,3529,0,0,0,0,1
3538,1.023552905575332,1216,4754,0,0,0,0,1
1265,1.023552905575332,2331,3596,0,0,0,0,1
3853,1.023552905575332,1015,4868,0,0,0,0,1
1185,1.023552905575332,2389,3574,0,0,0,0,1
2442,1.023552905575332,1072,3514,0,0,0,0,1
1194,1.023552905575332,2389,3583,0,0,0,0,1
3460,1.023552905575332,1236,4696,0,0,0,0,1
3234,1.023552905575332,1154,4388,0,0,0,0,1
2887,1.023552905575332,669,3556,0,0,0,0,1
1650,1.023552905575332,1947,3597,0,0,0,0,1
1118,1.023552905575332,2413,3531,0,0,0,0,1
1029,1.023552905575332,2427,3456,0,0,0,0,1
1177,1.023552905575332,2379,3556,0,0,0,0,1
1118,1.023552905575332,2414,3532,0,0,0,0,1
3635,1.023552905575332,1161,4796,0,0,0,0,1
3458,1.023552905575332,1239,4697,0,0,0,0,1
3644,1.023552905575332,1161,4805,0,0,0,0,1
1320,1.023552905575332,2337,3657,0,0,0,0,1
2442,1.023552905575332,1106,3548,0,0,0,0,1
1284,1.023552905575332,2338,3622,0,0,0,0,1
3768,1.023552905575332,1087,4855,0,0,0,0,1
3711,1.023552905575332,1111,4822,0,0,0,0,1
3620,1.023552905575332,1154,4774,0,0,0,0,1
3767,1.023552905575332,1090,4857,0,0,0,0,1
1171,1.023552905575332,2389,3560,0,0,0,0,1
1189,1.023552905575332,2389,3578,0,0,0,0,1
3709,1.023552905575332,1114,4823,0,0,0,0,1
1246,1.023552905575332,2357,3603,0,0,0,0,1
1997,1.023552905575332,1114,3111,0,0,0,0,1
3859,1.023552905575332,1010,4869,0,0,0,0,1
1068,1.023552905575332,2388,3456,0,0,0,0,1
