struct_elem,sw_part,start1,end1,start2,end2,start3,end3,type
1591,1.023552905575332,1495,3086,0,0,0,0,1
1462,1.023552905575332,1609,3071,0,0,0,0,1
1026,1.023552905575332,1953,2979,0,0,0,0,1
1553,1.023552905575332,1507,3060,0,0,0,0,1
1389,1.023552905575332,1545,2934,0,0,0,0,1
1571,0.05241373030456243,1507,3078,0,0,0,0,1
1524,1.023552905575332,1519,3043,0,0,0,0,1
1643,1.023552905575332,1464,3107,0,0,0,0,1
1298,1.023552905575332,1588,2886,0,0,0,0,1
1169,1.023552905575332,1577,2746,0,0,0,0,1
1140,1.023552905575332,1607,2747,0,0,0,0,1
1667,1.023552905575332,1445,3112,0,0,0,0,1
1315,1.023552905575332,1572,2887,0,0,0,0,1
1153,1.023552905575332,1599,2752,0,0,0,0,1
1647,1.023552905575332,1489,3136,0,0,0,0,1
1600,1.023552905575332,1501,3101,0,0,0,0,1
2444,1.023552905575332,522,2966,0,0,0,0,1
2433,1.023552905575332,533,2966,0,0,0,0,1
1641,1.023552905575332,1467,3108,0,0,0,0,1
1591,1.023552905575332,1502,3093,0,0,0,0,1
1595,1.023552905575332,1494,3089,0,0,0,0,1
1535,1.023552905575332,1496,3031,0,0,0,0,1
1046,1.023552905575332,1917,2963,0,0,0,0,1
995,1.023552905575332,1969,2964,0,0,0,0,1
1568,1.023552905575332,1495,3063,0,0,0,0,1
1466,1.023552905575332,1517,2983,0,0,0,0,1
1279,1.023552905575332,1607,2886,0,0,0,0,1
1013,1.023552905575332,1969,2982,0,0,0,0,1
1313,1.023552905575332,1576,2889,0,0,0,0,1
1440,1.023552905575332,1624,3064,0,0,0,0,1
1420,1.023552905575332,1695,3115,0,0,0,0,1
1593,1.023552905575332,1506,3099,0,0,0,0,1
1557,1.023552905575332,1507,3064,0,0,0,0,1
1986,0.07694899437870663,1560,3546,0,0,0,0,1
1146,1.023552905575332,1577,2723,0,0,0,0,1
1869,1.023552905575332,1586,3455,0,0,0,0,1
1598,1.023552905575332,1505,3103,0,0,0,0,1
1293,1.023552905575332,1588,2881,0,0,0,0,1
1958,0.09059438086496047,1588,3546,0,0,0,0,1
1450,1.023552905575332,1613,3063,0,0,0,0,1
1190,0.00507366743637253,1579,2769,0,0,0,0,1
1306,1.023552905575332,1580,2886,0,0,0,0,1
1311,1.023552905575332,1588,2899,0,0,0,0,1
1869,1.023552905575332,1587,3456,0,0,0,0,1
1191,1.023552905575332,1568,2759,0,0,0,0,1
1645,1.023552905575332,1467,3112,0,0,0,0,1
2473,1.023552905575332,491,2964,0,0,0,0,1
2408,1.023552905575332,545,2953,0,0,0,0,1
1032,1.023552905575332,1949,2981,0,0,0,0,1
1967,2031.3730361314263,1579,3546,0,0,0,0,1
1200,20.854157762249663,1569,2769,0,0,0,0,1
1646,1.023552905575332,1482,3128,0,0,0,0,1
1265,1.023552905575332,1607,2872,0,0,0,0,1
1153,1.023552905575332,1975,3128,0,0,0,0,1
1164,0.005274656507822021,1602,2766,0,0,0,0,1
1274,1.023552905575332,1607,2881,0,0,0,0,1
1593,1.023552905575332,1505,3098,0,0,0,0,1
1905,1.023552905575332,1552,3457,0,0,0,0,1
1523,1.023552905575332,1519,3042,0,0,0,0,1
1297,1.023552905575332,1588,2885,0,0,0,0,1
1139,1.023552905575332,1607,2746,0,0,0,0,1
2434,1.023552905575332,521,2955,0,0,0,0,1
1143,1.023552905575332,1599,2742,0,0,0,0,1
2443,1.023552905575332,521,2964,0,0,0,0,1
1152,1.023552905575332,1976,3128,0,0,0,0,1
1152,1.023552905575332,1599,2751,0,0,0,0,1
1182,1.023552905575332,1576,2758,0,0,0,0,1
1135,0.08268430004896392,1588,2723,0,0,0,0,1
1541,1.023552905575332,1492,3033,0,0,0,0,1
1646,1.023552905575332,1489,3135,0,0,0,0,1
1143,1.023552905575332,1600,2743,0,0,0,0,1
1045,1.023552905575332,1916,2961,0,0,0,0,1
2432,1.023552905575332,533,2965,0,0,0,0,1
1640,1.023552905575332,1467,3107,0,0,0,0,1
1045,21.18606150846374,1967,3012,0,0,0,0,1
1567,1.023552905575332,1495,3062,0,0,0,0,1
1535,1.023552905575332,1529,3064,0,0,0,0,1
1646,1.023552905575332,1481,3127,0,0,0,0,1
1392,1.023552905575332,1544,2936,0,0,0,0,1
1278,1.023552905575332,1607,2885,0,0,0,0,1
1644,1.023552905575332,1492,3136,0,0,0,0,1
1626,1.023552905575332,1493,3119,0,0,0,0,1
1641,1.023552905575332,1474,3115,0,0,0,0,1
1985,0.03998981619790975,1560,3545,0,0,0,0,1
1866,1.023552905575332,1615,3481,0,0,0,0,1
1868,1.023552905575332,1586,3454,0,0,0,0,1
1663,1.023552905575332,1466,3129,0,0,0,0,1
1652,1.023552905575332,1477,3129,0,0,0,0,1
1491,1.023552905575332,1552,3043,0,0,0,0,1
1873,1.023552905575332,1585,3458,0,0,0,0,1
1305,1.023552905575332,1580,2885,0,0,0,0,1
2468,1.023552905575332,498,2966,0,0,0,0,1
1448,1.023552905575332,1616,3064,0,0,0,0,1
2928,0.06826323068958132,529,3457,0,0,0,0,1
1190,1.023552905575332,1568,2758,0,0,0,0,1
1154,0.007350194687507253,1569,2723,0,0,0,0,1
1427,1.023552905575332,1612,3039,0,0,0,0,1
1174,1.023552905575332,1572,2746,0,0,0,0,1
1463,1.023552905575332,1520,2983,0,0,0,0,1
1297,1.023552905575332,1587,2884,0,0,0,0,1
1047,1.023552905575332,1918,2965,0,0,0,0,1
1966,14568.94208199656,1579,3545,0,0,0,0,1
1042,12.540362256326302,1970,3012,0,0,0,0,1
1053,1.023552905575332,1959,3012,0,0,0,0,1
1264,1.023552905575332,1607,2871,0,0,0,0,1
1152,1.023552905575332,1975,3127,0,0,0,0,1
1975,129.80731107637763,1579,3554,0,0,0,0,1
1113,1.023552905575332,1577,2690,0,0,0,0,1
1643,1.023552905575332,1484,3127,0,0,0,0,1
1627,1.023552905575332,1474,3101,0,0,0,0,1
1636,1.023552905575332,1474,3110,0,0,0,0,1
1140,1.023552905575332,1577,2717,0,0,0,0,1
1640,1.023552905575332,1466,3106,0,0,0,0,1
1426,1.023552905575332,1613,3039,0,0,0,0,1
1029,1.023552905575332,1952,2981,0,0,0,0,1
1160,1.023552905575332,1598,2758,0,0,0,0,1
1904,1.023552905575332,1552,3456,0,0,0,0,1
1145,1.023552905575332,1576,2721,0,0,0,0,1
1138,1.023552905575332,1607,2745,0,0,0,0,1
2433,1.023552905575332,521,2954,0,0,0,0,1
2422,1.023552905575332,532,2954,0,0,0,0,1
1052,1.023552905575332,1960,3012,0,0,0,0,1
1671,1.023552905575332,1458,3129,0,0,0,0,1
1204,1.023552905575332,1977,3181,0,0,0,0,1
1151,1.023552905575332,1599,2750,0,0,0,0,1
2476,1.023552905575332,490,2966,0,0,0,0,1
1642,1.023552905575332,1470,3112,0,0,0,0,1
1312,1.023552905575332,1575,2887,0,0,0,0,1
1301,1.023552905575332,1586,2887,0,0,0,0,1
1162,0.06826376478356613,1561,2723,0,0,0,0,1
1639,1.023552905575332,1467,3106,0,0,0,0,1
1319,1.023552905575332,1586,2905,0,0,0,0,1
2431,1.023552905575332,524,2955,0,0,0,0,1
1597,1.023552905575332,1504,3101,0,0,0,0,1
1443,9.862362265077358,1892,3335,0,0,0,0,1
1044,26.256579165880023,1967,3011,0,0,0,0,1
1149,1.023552905575332,1602,2751,0,0,0,0,1
1463,1.023552905575332,1519,2982,0,0,0,0,1
1591,1.023552905575332,1496,3087,0,0,0,0,1
1643,1.023552905575332,1492,3135,0,0,0,0,1
1143,136080.3680348813,1579,2722,0,0,0,0,1
1635,1.023552905575332,1466,3101,0,0,0,0,1
1146,1.023552905575332,1598,2744,0,0,0,0,1
1640,1.023552905575332,1474,3114,0,0,0,0,1
1015,1.023552905575332,1952,2967,0,0,0,0,1
1644,1.023552905575332,1466,3110,0,0,0,0,1
1653,1.023552905575332,1466,3119,0,0,0,0,1
1189,1.023552905575332,1567,2756,0,0,0,0,1
1662,1.023552905575332,1466,3128,0,0,0,0,1
1622,0.008121048028881868,1507,3129,0,0,0,0,1
1651,1.023552905575332,1477,3128,0,0,0,0,1
1490,1.023552905575332,1552,3042,0,0,0,0,1
1872,1.023552905575332,1585,3457,0,0,0,0,1
1541,1.023552905575332,1491,3032,0,0,0,0,1
1543,1.023552905575332,1494,3037,0,0,0,0,1
1153,0.005935028234531883,1569,2722,0,0,0,0,1
1316,1.023552905575332,1575,2891,0,0,0,0,1
1052,1.023552905575332,1958,3010,0,0,0,0,1
1660,1.023552905575332,1469,3129,0,0,0,0,1
1517,1.023552905575332,1525,3042,0,0,0,0,1
1296,1.023552905575332,1587,2883,0,0,0,0,1
1041,15.550598745367633,1970,3011,0,0,0,0,1
2427,1.023552905575332,539,2966,0,0,0,0,1
1449,1.023552905575332,1611,3060,0,0,0,0,1
1593,1.023552905575332,1493,3086,0,0,0,0,1
1460,1.023552905575332,1522,2982,0,0,0,0,1
1458,1.023552905575332,1611,3069,0,0,0,0,1
1391,1.023552905575332,1543,2934,0,0,0,0,1
1046,1.023552905575332,1919,2965,0,0,0,0,1
1158,1.023552905575332,1977,3135,0,0,0,0,1
1526,1.023552905575332,1517,3043,0,0,0,0,1
1639,1.023552905575332,1466,3105,0,0,0,0,1
1019,1.023552905575332,1952,2971,0,0,0,0,1
1435,1.023552905575332,1545,2980,0,0,0,0,1
1149,1.023552905575332,1978,3127,0,0,0,0,1
1311,1.023552905575332,1574,2885,0,0,0,0,1
1158,1.023552905575332,1978,3136,0,0,0,0,1
1267,1.023552905575332,1605,2872,0,0,0,0,1
1538,1.023552905575332,1494,3032,0,0,0,0,1
1596,1.023552905575332,1503,3099,0,0,0,0,1
1547,1.023552905575332,1494,3041,0,0,0,0,1
1637,1.023552905575332,1469,3106,0,0,0,0,1
1311,1.023552905575332,1575,2886,0,0,0,0,1
1148,1.023552905575332,1601,2749,0,0,0,0,1
1016,1.023552905575332,1967,2983,0,0,0,0,1
1161,0.0833243370401099,1561,2722,0,0,0,0,1
1121,136.8895190033612,1602,2723,0,0,0,0,1
1565,1.023552905575332,1494,3059,0,0,0,0,1
1597,1.023552905575332,1492,3089,0,0,0,0,1
2430,1.023552905575332,524,2954,0,0,0,0,1
1596,1.023552905575332,1504,3100,0,0,0,0,1
1442,10.139332404479283,1892,3334,0,0,0,0,1
1462,1.023552905575332,1519,2981,0,0,0,0,1
1639,1.023552905575332,1473,3112,0,0,0,0,1
2467,1.023552905575332,497,2964,0,0,0,0,1
1453,1.023552905575332,1611,3064,0,0,0,0,1
1032,1.023552905575332,1951,2983,0,0,0,0,1
1559,1.023552905575332,1505,3064,0,0,0,0,1
1142,1.023552905575332,1579,2721,0,0,0,0,1
1005,1.023552905575332,1952,2957,0,0,0,0,1
1388,1.023552905575332,1546,2934,0,0,0,0,1
1634,1.023552905575332,1466,3100,0,0,0,0,1
1145,1.023552905575332,1598,2743,0,0,0,0,1
1643,1.023552905575332,1466,3109,0,0,0,0,1
1144,1.023552905575332,1978,3122,0,0,0,0,1
1871,1.023552905575332,1585,3456,0,0,0,0,1
1058,1.023552905575332,1954,3012,0,0,0,0,1
1196,42.90430426365789,1570,2766,0,0,0,0,1
1542,1.023552905575332,1494,3036,0,0,0,0,1
1171,1.023552905575332,1574,2745,0,0,0,0,1
1013,1.023552905575332,1970,2983,0,0,0,0,1
1869,149.92218687753703,1588,3457,0,0,0,0,1
1600,1.023552905575332,1504,3104,0,0,0,0,1
1045,1.023552905575332,1918,2963,0,0,0,0,1
1643,1.023552905575332,1491,3134,0,0,0,0,1
1567,1.023552905575332,1496,3063,0,0,0,0,1
1897,15.810051984224515,1561,3458,0,0,0,0,1
1171,1.023552905575332,1575,2746,0,0,0,0,1
1459,1.023552905575332,1522,2981,0,0,0,0,1
1313,1.023552905575332,1578,2891,0,0,0,0,1
1148,1.023552905575332,1977,3125,0,0,0,0,1
1009,1.023552905575332,1952,2961,0,0,0,0,1
1525,1.023552905575332,1517,3042,0,0,0,0,1
1432,1.023552905575332,1615,3047,0,0,0,0,1
1640,1.023552905575332,1487,3127,0,0,0,0,1
1018,1.023552905575332,1952,2970,0,0,0,0,1
1649,1.023552905575332,1487,3136,0,0,0,0,1
1027,1.023552905575332,1952,2979,0,0,0,0,1
2435,1.023552905575332,531,2966,0,0,0,0,1
1643,1.023552905575332,1465,3108,0,0,0,0,1
1148,1.023552905575332,1978,3126,0,0,0,0,1
1544,1.023552905575332,1491,3035,0,0,0,0,1
1537,1.023552905575332,1494,3031,0,0,0,0,1
1595,1.023552905575332,1503,3098,0,0,0,0,1
1546,1.023552905575332,1494,3040,0,0,0,0,1
1015,1.023552905575332,1967,2982,0,0,0,0,1
1120,100.68850314791781,1602,2722,0,0,0,0,1
1553,1.023552905575332,1496,3049,0,0,0,0,1
1461,1.023552905575332,1610,3071,0,0,0,0,1
1148,1.023552905575332,1575,2723,0,0,0,0,1
1523,1.023552905575332,1520,3043,0,0,0,0,1
1452,1.023552905575332,1611,3063,0,0,0,0,1
1672,1.023552905575332,1442,3114,0,0,0,0,1
1438,1.023552905575332,1544,2982,0,0,0,0,1
1031,1.023552905575332,1951,2982,0,0,0,0,1
1841,1.023552905575332,1614,3455,0,0,0,0,1
1635,1.023552905575332,1487,3122,0,0,0,0,1
1665,1.023552905575332,1464,3129,0,0,0,0,1
1508,1.023552905575332,1531,3039,0,0,0,0,1
1438,1.023552905575332,1545,2983,0,0,0,0,1
1647,1.023552905575332,1465,3112,0,0,0,0,1
1636,1.023552905575332,1476,3112,0,0,0,0,1
2464,1.023552905575332,500,2964,0,0,0,0,1
1640,1.023552905575332,1468,3108,0,0,0,0,1
1057,1.023552905575332,1954,3011,0,0,0,0,1
1306,1.023552905575332,1581,2887,0,0,0,0,1
1186,1.023552905575332,1570,2756,0,0,0,0,1
1590,1.023552905575332,1503,3093,0,0,0,0,1
1142,1.023552905575332,1601,2743,0,0,0,0,1
994,1.023552905575332,1970,2964,0,0,0,0,1
1465,1.023552905575332,1518,2983,0,0,0,0,1
1299,1.023552905575332,1585,2884,0,0,0,0,1
1170,1.023552905575332,1574,2744,0,0,0,0,1
1043,1.023552905575332,1920,2963,0,0,0,0,1
1868,1.023552905575332,1588,3456,0,0,0,0,1
1055,1.023552905575332,1957,3012,0,0,0,0,1
1312,1.023552905575332,1577,2889,0,0,0,0,1
1896,18.554843859913174,1561,3457,0,0,0,0,1
1646,1.023552905575332,1483,3129,0,0,0,0,1
1597,1.023552905575332,1506,3103,0,0,0,0,1
1312,1.023552905575332,1578,2890,0,0,0,0,1
1008,1.023552905575332,1952,2960,0,0,0,0,1
1025,1.023552905575332,1954,2979,0,0,0,0,1
1431,1.023552905575332,1615,3046,0,0,0,0,1
1433,1.023552905575332,1545,2978,0,0,0,0,1
2434,1.023552905575332,531,2965,0,0,0,0,1
1642,1.023552905575332,1465,3107,0,0,0,0,1
1271,1.023552905575332,1604,2875,0,0,0,0,1
1644,1.023552905575332,1468,3112,0,0,0,0,1
1314,1.023552905575332,1573,2887,0,0,0,0,1
1303,1.023552905575332,1584,2887,0,0,0,0,1
1491,11.16670080872043,1587,3078,0,0,0,0,1
1321,1.023552905575332,1584,2905,0,0,0,0,1
1646,1.023552905575332,1490,3136,0,0,0,0,1
1599,1.023552905575332,1502,3101,0,0,0,0,1
1534,1.023552905575332,1496,3030,0,0,0,0,1
2421,1.023552905575332,545,2966,0,0,0,0,1
1543,1.023552905575332,1496,3039,0,0,0,0,1
1465,1.023552905575332,1517,2982,0,0,0,0,1
1552,1.023552905575332,1496,3048,0,0,0,0,1
1012,1.023552905575332,1969,2981,0,0,0,0,1
1594,1.023552905575332,1495,3089,0,0,0,0,1
1419,1.023552905575332,1695,3114,0,0,0,0,1
1113,1.023552905575332,1579,2692,0,0,0,0,1
1556,1.023552905575332,1507,3063,0,0,0,0,1
1458,1.023552905575332,1521,2979,0,0,0,0,1
1574,0.08779335011397432,1507,3081,0,0,0,0,1
1957,0.06905439503839644,1588,3545,0,0,0,0,1
1301,1.023552905575332,1588,2889,0,0,0,0,1
1840,1.023552905575332,1614,3454,0,0,0,0,1
1670,1.023552905575332,1445,3115,0,0,0,0,1
1592,1.023552905575332,1507,3099,0,0,0,0,1
1534,1.023552905575332,1530,3064,0,0,0,0,1
1145,1.023552905575332,1578,2723,0,0,0,0,1
1431,1.023552905575332,1614,3045,0,0,0,0,1
1868,1.023552905575332,1587,3455,0,0,0,0,1
1507,1.023552905575332,1531,3038,0,0,0,0,1
1449,1.023552905575332,1614,3063,0,0,0,0,1
1056,1.023552905575332,1954,3010,0,0,0,0,1
1545,1.023552905575332,1492,3037,0,0,0,0,1
1305,1.023552905575332,1581,2886,0,0,0,0,1
1049,1.023552905575332,1916,2965,0,0,0,0,1
1190,1.023552905575332,1569,2759,0,0,0,0,1
1662,1.023552905575332,1467,3129,0,0,0,0,1
1054,1.023552905575332,1957,3011,0,0,0,0,1
1311,1.023552905575332,1577,2888,0,0,0,0,1
1556,1.023552905575332,1496,3052,0,0,0,0,1
1031,1.023552905575332,1950,2981,0,0,0,0,1
1645,1.023552905575332,1483,3128,0,0,0,0,1
1551,0.09940796302277118,1507,3058,0,0,0,0,1
1872,1.023552905575332,1586,3458,0,0,0,0,1
1522,1.023552905575332,1519,3041,0,0,0,0,1
1462,1.023552905575332,1521,2983,0,0,0,0,1
1578,1.023552905575332,1507,3085,0,0,0,0,1
1296,1.023552905575332,1588,2884,0,0,0,0,1
1639,1.023552905575332,1475,3114,0,0,0,0,1
1976,0.09549285522060627,1569,3545,0,0,0,0,1
1305,1.023552905575332,1588,2893,0,0,0,0,1
1309,1.023552905575332,1580,2889,0,0,0,0,1
1151,1.023552905575332,1976,3127,0,0,0,0,1
2927,0.08989111638756817,530,3457,0,0,0,0,1
1426,1.023552905575332,1614,3040,0,0,0,0,1
1153,0.020678282927362797,1570,2723,0,0,0,0,1
1511,1.023552905575332,1531,3042,0,0,0,0,1
1630,1.023552905575332,1476,3106,0,0,0,0,1
2433,1.023552905575332,522,2955,0,0,0,0,1
1142,1.023552905575332,1600,2742,0,0,0,0,1
2442,1.023552905575332,522,2964,0,0,0,0,1
1313,1.023552905575332,1573,2886,0,0,0,0,1
1151,1.023552905575332,1600,2751,0,0,0,0,1
1144,1.023552905575332,1603,2747,0,0,0,0,1
1645,1.023552905575332,1490,3135,0,0,0,0,1
1598,1.023552905575332,1502,3100,0,0,0,0,1
993,1.023552905575332,1969,2962,0,0,0,0,1
2420,1.023552905575332,545,2965,0,0,0,0,1
1542,1.023552905575332,1496,3038,0,0,0,0,1
1464,1.023552905575332,1517,2981,0,0,0,0,1
1046,1.023552905575332,1920,2966,0,0,0,0,1
1455,1.023552905575332,1609,3064,0,0,0,0,1
1311,1.023552905575332,1576,2887,0,0,0,0,1
1593,1.023552905575332,1495,3088,0,0,0,0,1
1135,1.023552905575332,1577,2712,0,0,0,0,1
1028,1.023552905575332,1953,2981,0,0,0,0,1
1555,1.023552905575332,1507,3062,0,0,0,0,1
1144,1.023552905575332,1577,2721,0,0,0,0,1
1391,1.023552905575332,1545,2936,0,0,0,0,1
1867,1.023552905575332,1586,3453,0,0,0,0,1
1643,1.023552905575332,1493,3136,0,0,0,0,1
1645,1.023552905575332,1464,3109,0,0,0,0,1
1669,1.023552905575332,1445,3114,0,0,0,0,1
1533,1.023552905575332,1530,3063,0,0,0,0,1
1984,0.07678966519046954,1561,3545,0,0,0,0,1
1317,1.023552905575332,1572,2889,0,0,0,0,1
1867,1.023552905575332,1587,3454,0,0,0,0,1
1506,1.023552905575332,1531,3037,0,0,0,0,1
1430,1.023552905575332,1614,3044,0,0,0,0,1
1651,1.023552905575332,1478,3129,0,0,0,0,1
1304,1.023552905575332,1581,2885,0,0,0,0,1
1643,1.023552905575332,1467,3110,0,0,0,0,1
1462,1.023552905575332,1520,2982,0,0,0,0,1
1030,1.023552905575332,1949,2979,0,0,0,0,1
1602,1.023552905575332,1502,3104,0,0,0,0,1
1382,1.023552905575332,1552,2934,0,0,0,0,1
1272,1.023552905575332,1607,2879,0,0,0,0,1
1053,1.023552905575332,1957,3010,0,0,0,0,1
1173,1.023552905575332,1573,2746,0,0,0,0,1
1404,1.023552905575332,1544,2948,0,0,0,0,1
1315,1.023552905575332,1576,2891,0,0,0,0,1
1550,0.09471698258017837,1507,3057,0,0,0,0,1
1139,1.023552905575332,1577,2716,0,0,0,0,1
1903,1.023552905575332,1552,3455,0,0,0,0,1
1871,1.023552905575332,1586,3457,0,0,0,0,1
1295,1.023552905575332,1588,2883,0,0,0,0,1
1304,1.023552905575332,1588,2892,0,0,0,0,1
1670,1.023552905575332,1458,3128,0,0,0,0,1
1150,1.023552905575332,1976,3126,0,0,0,0,1
1425,1.023552905575332,1614,3039,0,0,0,0,1
1152,0.018662507950018534,1570,2722,0,0,0,0,1
1159,1.023552905575332,1599,2758,0,0,0,0,1
1599,1.023552905575332,1490,3089,0,0,0,0,1
1539,1.023552905575332,1492,3031,0,0,0,0,1
1662,15.550719509390662,1507,3169,0,0,0,0,1
2432,1.023552905575332,522,2954,0,0,0,0,1
1498,1.023552905575332,1545,3043,0,0,0,0,1
1203,1.023552905575332,1978,3181,0,0,0,0,1
1150,1.023552905575332,1600,2750,0,0,0,0,1
2475,1.023552905575332,491,2966,0,0,0,0,1
1444,1.023552905575332,1620,3064,0,0,0,0,1
1597,1.023552905575332,1502,3099,0,0,0,0,1
1186,1.023552905575332,1572,2758,0,0,0,0,1
1565,1.023552905575332,1495,3060,0,0,0,0,1
1390,1.023552905575332,1544,2934,0,0,0,0,1
1642,1.023552905575332,1492,3134,0,0,0,0,1
1572,0.08380350318042856,1506,3078,0,0,0,0,1
1525,1.023552905575332,1518,3043,0,0,0,0,1
1454,1.023552905575332,1609,3063,0,0,0,0,1
1134,1.023552905575332,1577,2711,0,0,0,0,1
1554,1.023552905575332,1507,3061,0,0,0,0,1
1652,1.023552905575332,1466,3118,0,0,0,0,1
1661,1.023552905575332,1466,3127,0,0,0,0,1
1299,1.023552905575332,1588,2887,0,0,0,0,1
1489,1.023552905575332,1552,3041,0,0,0,0,1
1187,0.0024523291597087727,1579,2766,0,0,0,0,1
2466,1.023552905575332,498,2964,0,0,0,0,1
2445,1.023552905575332,521,2966,0,0,0,0,1
2434,1.023552905575332,532,2966,0,0,0,0,1
1154,1.023552905575332,1599,2753,0,0,0,0,1
1455,1.023552905575332,1616,3071,0,0,0,0,1
1188,1.023552905575332,1568,2756,0,0,0,0,1
1650,1.023552905575332,1478,3128,0,0,0,0,1
1315,1.023552905575332,1575,2890,0,0,0,0,1
1543,1.023552905575332,1492,3035,0,0,0,0,1
1047,1.023552905575332,1916,2963,0,0,0,0,1
1642,1.023552905575332,1467,3109,0,0,0,0,1
1461,1.023552905575332,1520,2981,0,0,0,0,1
1452,1.023552905575332,1612,3064,0,0,0,0,1
2426,1.023552905575332,539,2965,0,0,0,0,1
1051,1.023552905575332,1959,3010,0,0,0,0,1
1558,1.023552905575332,1506,3064,0,0,0,0,1
1271,1.023552905575332,1607,2878,0,0,0,0,1
1648,1.023552905575332,1481,3129,0,0,0,0,1
1314,1.023552905575332,1576,2890,0,0,0,0,1
1192,1.023552905575332,1567,2759,0,0,0,0,1
1157,1.023552905575332,1978,3135,0,0,0,0,1
2425,1.023552905575332,540,2965,0,0,0,0,1
1170,1.023552905575332,1576,2746,0,0,0,0,1
1631,1.023552905575332,1470,3101,0,0,0,0,1
2474,1.023552905575332,490,2964,0,0,0,0,1
1148,1.023552905575332,1979,3127,0,0,0,0,1
1299,1.023552905575332,1586,2885,0,0,0,0,1
1661,15.012001121606891,1507,3168,0,0,0,0,1
2409,1.023552905575332,544,2953,0,0,0,0,1
1157,1.023552905575332,1979,3136,0,0,0,0,1
1497,1.023552905575332,1545,3042,0,0,0,0,1
1266,1.023552905575332,1606,2872,0,0,0,0,1
1648,1.023552905575332,1488,3136,0,0,0,0,1
2474,1.023552905575332,491,2965,0,0,0,0,1
1595,1.023552905575332,1504,3099,0,0,0,0,1
1555,1.023552905575332,1495,3050,0,0,0,0,1
1461,1.023552905575332,1519,2980,0,0,0,0,1
1564,1.023552905575332,1495,3059,0,0,0,0,1
1312,1.023552905575332,1579,2891,0,0,0,0,1
1596,1.023552905575332,1493,3089,0,0,0,0,1
1906,1.023552905575332,1551,3457,0,0,0,0,1
1524,1.023552905575332,1518,3042,0,0,0,0,1
1133,1.023552905575332,1577,2710,0,0,0,0,1
1638,1.023552905575332,1474,3112,0,0,0,0,1
1642,1.023552905575332,1466,3108,0,0,0,0,1
1651,1.023552905575332,1466,3117,0,0,0,0,1
1594,1.023552905575332,1505,3099,0,0,0,0,1
1147,1.023552905575332,1576,2723,0,0,0,0,1
1870,1.023552905575332,1585,3455,0,0,0,0,1
1488,1.023552905575332,1552,3040,0,0,0,0,1
1387,1.023552905575332,1547,2934,0,0,0,0,1
1144,1.023552905575332,1599,2743,0,0,0,0,1
1522,1.023552905575332,1521,3043,0,0,0,0,1
1541,1.023552905575332,1494,3035,0,0,0,0,1
1467,1.023552905575332,1516,2983,0,0,0,0,1
1314,1.023552905575332,1575,2889,0,0,0,0,1
1599,1.023552905575332,1504,3103,0,0,0,0,1
1451,1.023552905575332,1612,3063,0,0,0,0,1
1647,1.023552905575332,1481,3128,0,0,0,0,1
1593,1.023552905575332,1496,3089,0,0,0,0,1
1389,1.023552905575332,1543,2932,0,0,0,0,1
1874,1.023552905575332,1584,3458,0,0,0,0,1
1580,1.023552905575332,1505,3085,0,0,0,0,1
1017,1.023552905575332,1952,2969,0,0,0,0,1
1458,1.023552905575332,1523,2981,0,0,0,0,1
1867,1.023552905575332,1615,3482,0,0,0,0,1
1646,1.023552905575332,1466,3112,0,0,0,0,1
1026,1.023552905575332,1952,2978,0,0,0,0,1
1147,1.023552905575332,1978,3125,0,0,0,0,1
1191,1.023552905575332,1567,2758,0,0,0,0,1
1536,1.023552905575332,1494,3030,0,0,0,0,1
2929,0.0893786431913866,529,3458,0,0,0,0,1
1199,18.48579228627184,1570,2769,0,0,0,0,1
1545,1.023552905575332,1494,3039,0,0,0,0,1
1298,1.023552905575332,1586,2884,0,0,0,0,1
1156,1.023552905575332,1979,3135,0,0,0,0,1
1014,1.023552905575332,1967,2981,0,0,0,0,1
1054,1.023552905575332,1958,3012,0,0,0,0,1
1647,1.023552905575332,1488,3135,0,0,0,0,1
1594,1.023552905575332,1504,3098,0,0,0,0,1
1048,1.023552905575332,1918,2966,0,0,0,0,1
1522,1.023552905575332,1520,3042,0,0,0,0,1
1595,1.023552905575332,1493,3088,0,0,0,0,1
1460,1.023552905575332,1611,3071,0,0,0,0,1
1030,1.023552905575332,1951,2981,0,0,0,0,1
1557,1.023552905575332,1505,3062,0,0,0,0,1
1393,1.023552905575332,1543,2936,0,0,0,0,1
1151,1.023552905575332,1977,3128,0,0,0,0,1
1641,1.023552905575332,1466,3107,0,0,0,0,1
1021,1.023552905575332,1952,2973,0,0,0,0,1
1650,1.023552905575332,1466,3116,0,0,0,0,1
1437,1.023552905575332,1545,2982,0,0,0,0,1
1030,1.023552905575332,1952,2982,0,0,0,0,1
1162,0.007717715530838582,1967,3129,0,0,0,0,1
1869,1.023552905575332,1585,3454,0,0,0,0,1
1313,1.023552905575332,1574,2887,0,0,0,0,1
1163,0.046621035300430894,1560,2723,0,0,0,0,1
1664,1.023552905575332,1465,3129,0,0,0,0,1
2432,1.023552905575332,523,2955,0,0,0,0,1
1598,1.023552905575332,1503,3101,0,0,0,0,1
1141,1.023552905575332,1601,2742,0,0,0,0,1
1438,1.023552905575332,1626,3064,0,0,0,0,1
1313,1.023552905575332,1575,2888,0,0,0,0,1
1150,1.023552905575332,1601,2751,0,0,0,0,1
1464,1.023552905575332,1518,2982,0,0,0,0,1
1642,1.023552905575332,1488,3130,0,0,0,0,1
1598,1.023552905575332,1504,3102,0,0,0,0,1
2415,1.023552905575332,539,2954,0,0,0,0,1
1464,1.023552905575332,1519,2983,0,0,0,0,1
1457,1.023552905575332,1522,2979,0,0,0,0,1
2469,1.023552905575332,497,2966,0,0,0,0,1
1455,1.023552905575332,1611,3066,0,0,0,0,1
1311,1.023552905575332,1578,2889,0,0,0,0,1
1144,26455146.345687754,1579,2723,0,0,0,0,1
1397,1.023552905575332,1543,2940,0,0,0,0,1
1491,1.023552905575332,1551,3042,0,0,0,0,1
1430,1.023552905575332,1615,3045,0,0,0,0,1
1007,1.023552905575332,1952,2959,0,0,0,0,1
1016,1.023552905575332,1952,2968,0,0,0,0,1
1025,1.023552905575332,1952,2977,0,0,0,0,1
1141,1.023552905575332,1576,2717,0,0,0,0,1
2433,1.023552905575332,531,2964,0,0,0,0,1
1641,1.023552905575332,1465,3106,0,0,0,0,1
1448,1.023552905575332,1615,3063,0,0,0,0,1
1639,1.023552905575332,1476,3115,0,0,0,0,1
1542,1.023552905575332,1491,3033,0,0,0,0,1
1535,1.023552905575332,1494,3029,0,0,0,0,1
1672,1.023552905575332,1457,3129,0,0,0,0,1
1189,1.023552905575332,1570,2759,0,0,0,0,1
2422,1.023552905575332,543,2965,0,0,0,0,1
1544,1.023552905575332,1494,3038,0,0,0,0,1
1297,1.023552905575332,1586,2883,0,0,0,0,1
1643,1.023552905575332,1469,3112,0,0,0,0,1
1446,1.023552905575332,1618,3064,0,0,0,0,1
1053,1.023552905575332,1958,3011,0,0,0,0,1
1173,1.023552905575332,1574,2747,0,0,0,0,1
1392,1.023552905575332,1542,2934,0,0,0,0,1
1645,1.023552905575332,1491,3136,0,0,0,0,1
1521,1.023552905575332,1520,3041,0,0,0,0,1
1450,1.023552905575332,1611,3061,0,0,0,0,1
1546,1.023552905575332,1489,3035,0,0,0,0,1
1472,1.023552905575332,1511,2983,0,0,0,0,1
1461,1.023552905575332,1522,2983,0,0,0,0,1
1670,1.023552905575332,1442,3112,0,0,0,0,1
1436,1.023552905575332,1544,2980,0,0,0,0,1
1459,1.023552905575332,1611,3070,0,0,0,0,1
1150,1.023552905575332,1977,3127,0,0,0,0,1
1159,1.023552905575332,1977,3136,0,0,0,0,1
1591,1.023552905575332,1507,3098,0,0,0,0,1
1020,1.023552905575332,1952,2972,0,0,0,0,1
1625,1.023552905575332,1476,3101,0,0,0,0,1
1634,1.023552905575332,1476,3110,0,0,0,0,1
1150,1.023552905575332,1978,3128,0,0,0,0,1
1638,1.023552905575332,1468,3106,0,0,0,0,1
1312,1.023552905575332,1574,2886,0,0,0,0,1
1017,1.023552905575332,1966,2983,0,0,0,0,1
1162,0.06242589180695694,1560,2722,0,0,0,0,1
1663,1.023552905575332,1465,3128,0,0,0,0,1
1533,1.023552905575332,1531,3064,0,0,0,0,1
1539,1.023552905575332,1494,3033,0,0,0,0,1
2431,1.023552905575332,523,2954,0,0,0,0,1
1597,1.023552905575332,1503,3100,0,0,0,0,1
1437,1.023552905575332,1626,3063,0,0,0,0,1
1149,1.023552905575332,1601,2750,0,0,0,0,1
1048,1.023552905575332,1917,2965,0,0,0,0,1
1454,1.023552905575332,1610,3064,0,0,0,0,1
1866,1.023552905575332,1588,3454,0,0,0,0,1
1310,1.023552905575332,1577,2887,0,0,0,0,1
1555,1.023552905575332,1496,3051,0,0,0,0,1
1564,1.023552905575332,1496,3060,0,0,0,0,1
1644,1.023552905575332,1483,3127,0,0,0,0,1
1022,1.023552905575332,1948,2970,0,0,0,0,1
1454,1.023552905575332,1611,3065,0,0,0,0,1
1461,1.023552905575332,1521,2982,0,0,0,0,1
1577,1.023552905575332,1507,3084,0,0,0,0,1
1872,1.023552905575332,1584,3456,0,0,0,0,1
1006,1.023552905575332,1952,2958,0,0,0,0,1
1429,1.023552905575332,1615,3044,0,0,0,0,1
2423,1.023552905575332,531,2954,0,0,0,0,1
1871,4051.7642066384597,1587,3458,0,0,0,0,1
1510,1.023552905575332,1531,3041,0,0,0,0,1
1629,1.023552905575332,1476,3105,0,0,0,0,1
1638,1.023552905575332,1476,3114,0,0,0,0,1
2477,1.023552905575332,489,2966,0,0,0,0,1
1642,1.023552905575332,1468,3110,0,0,0,0,1
1308,1.023552905575332,1581,2889,0,0,0,0,1
1471,10.02708680285896,1587,3058,0,0,0,0,1
1312,1.023552905575332,1573,2885,0,0,0,0,1
1465,1.023552905575332,1606,3071,0,0,0,0,1
1454,1.023552905575332,1617,3071,0,0,0,0,1
1671,1.023552905575332,1457,3128,0,0,0,0,1
1898,17.614262308007135,1560,3458,0,0,0,0,1
1541,1.023552905575332,1496,3037,0,0,0,0,1
1172,1.023552905575332,1574,2746,0,0,0,0,1
1143,1.023552905575332,1604,2747,0,0,0,0,1
1045,1.023552905575332,1920,2965,0,0,0,0,1
1870,2031.2562970347035,1588,3458,0,0,0,0,1
1314,1.023552905575332,1577,2891,0,0,0,0,1
1592,1.023552905575332,1495,3087,0,0,0,0,1
1644,1.023552905575332,1491,3135,0,0,0,0,1
1111,1.023552905575332,1579,2690,0,0,0,0,1
1028,1.023552905575332,1951,2979,0,0,0,0,1
1443,1.023552905575332,1621,3064,0,0,0,0,1
1644,1.023552905575332,1464,3108,0,0,0,0,1
1149,1.023552905575332,1977,3126,0,0,0,0,1
1424,1.023552905575332,1615,3039,0,0,0,0,1
1632,1.023552905575332,1487,3119,0,0,0,0,1
1134,1.023552905575332,1578,2712,0,0,0,0,1
1027,1.023552905575332,1954,2981,0,0,0,0,1
1641,1.023552905575332,1487,3128,0,0,0,0,1
1317,1.023552905575332,1588,2905,0,0,0,0,1
1866,1.023552905575332,1587,3453,0,0,0,0,1
1624,1.023552905575332,1476,3100,0,0,0,0,1
1644,1.023552905575332,1465,3109,0,0,0,0,1
1879,0.00855836218793156,1579,3458,0,0,0,0,1
1646,1.023552905575332,1468,3114,0,0,0,0,1
1532,1.023552905575332,1531,3063,0,0,0,0,1
2474,1.023552905575332,492,2966,0,0,0,0,1
1316,1.023552905575332,1573,2889,0,0,0,0,1
1305,1.023552905575332,1584,2889,0,0,0,0,1
2430,1.023552905575332,523,2953,0,0,0,0,1
1518,1.023552905575332,1524,3042,0,0,0,0,1
1197,48.42745274216365,1569,2766,0,0,0,0,1
1453,1.023552905575332,1610,3063,0,0,0,0,1
1554,1.023552905575332,1496,3050,0,0,0,0,1
1014,1.023552905575332,1969,2983,0,0,0,0,1
1403,1.023552905575332,1544,2947,0,0,0,0,1
1649,1.023552905575332,1479,3128,0,0,0,0,1
1563,1.023552905575332,1496,3059,0,0,0,0,1
1029,1.023552905575332,1950,2979,0,0,0,0,1
1666,1.023552905575332,1463,3129,0,0,0,0,1
1870,1.023552905575332,1586,3456,0,0,0,0,1
1460,1.023552905575332,1521,2981,0,0,0,0,1
1439,1.023552905575332,1544,2983,0,0,0,0,1
1294,1.023552905575332,1588,2882,0,0,0,0,1
1637,1.023552905575332,1475,3112,0,0,0,0,1
2465,1.023552905575332,499,2964,0,0,0,0,1
1585,1.023552905575332,1507,3092,0,0,0,0,1
1451,1.023552905575332,1613,3064,0,0,0,0,1
1307,1.023552905575332,1580,2887,0,0,0,0,1
1058,1.023552905575332,1953,3011,0,0,0,0,1
1424,1.023552905575332,1614,3038,0,0,0,0,1
1870,304.1416650014599,1587,3457,0,0,0,0,1
1509,1.023552905575332,1531,3040,0,0,0,0,1
1628,1.023552905575332,1476,3104,0,0,0,0,1
1268,1.023552905575332,1604,2872,0,0,0,0,1
1538,1.023552905575332,1492,3030,0,0,0,0,1
2431,1.023552905575332,522,2953,0,0,0,0,1
1641,1.023552905575332,1468,3109,0,0,0,0,1
2409,1.023552905575332,545,2954,0,0,0,0,1
1897,18.262754514357212,1560,3457,0,0,0,0,1
1647,1.023552905575332,1482,3129,0,0,0,0,1
1202,1.023552905575332,1979,3181,0,0,0,0,1
1540,1.023552905575332,1496,3036,0,0,0,0,1
1275,1.023552905575332,1607,2882,0,0,0,0,1
1313,1.023552905575332,1577,2890,0,0,0,0,1
