struct_elem,sw_part,start1,end1,start2,end2,start3,end3,type
3824,1.023552905575332,1041,4865,0,0,0,0,1
1292,1.023552905575332,2330,3622,0,0,0,0,1
3699,1.023552905575332,1132,4831,0,0,0,0,1
3688,1.023552905575332,1143,4831,0,0,0,0,1
1055,1.023552905575332,2429,3484,0,0,0,0,1
1216,1.023552905575332,2387,3603,0,0,0,0,1
3601,1.023552905575332,1179,4780,0,0,0,0,1
1136,1.023552905575332,2419,3555,0,0,0,0,1
3698,1.023552905575332,1133,4831,0,0,0,0,1
3641,1.023552905575332,1157,4798,0,0,0,0,1
3592,1.023552905575332,1180,4772,0,0,0,0,1
1561,1.023552905575332,1994,3555,0,0,0,0,1
2005,1.023552905575332,1106,3111,0,0,0,0,1
3856,1.023552905575332,1013,4869,0,0,0,0,1
1283,1.023552905575332,2338,3621,0,0,0,0,1
2440,1.023552905575332,655,3095,0,0,0,0,1
2449,1.023552905575332,655,3104,0,0,0,0,1
3641,1.023552905575332,1163,4804,0,0,0,0,1
1983,1.023552905575332,1129,3112,0,0,0,0,1
1559,1.023552905575332,1997,3556,0,0,0,0,1
1159,1.023552905575332,2418,3577,0,0,0,0,1
3544,1.023552905575332,1210,4754,0,0,0,0,1
3793,1.023552905575332,1089,4882,0,0,0,0,1
3668,1.023552905575332,1163,4831,0,0,0,0,1
3455,1.023552905575332,1242,4697,0,0,0,0,1
1063,1.023552905575332,2421,3484,0,0,0,0,1
1052,1.023552905575332,2432,3484,0,0,0,0,1
1170,1.023552905575332,2389,3559,0,0,0,0,1
3254,1.023552905575332,1155,4409,0,0,0,0,1
3348,0.06448621210658312,1090,4438,0,0,0,0,1
3571,1.023552905575332,1210,4781,0,0,0,0,1
3824,1.023552905575332,1040,4864,0,0,0,0,1
1197,1.023552905575332,2380,3577,0,0,0,0,1
3326,1.023552905575332,1113,4439,0,0,0,0,1
3649,1.023552905575332,1149,4798,0,0,0,0,1
3638,1.023552905575332,1160,4798,0,0,0,0,1
3596,1.023552905575332,1180,4776,0,0,0,0,1
1067,1.023552905575332,2388,3455,0,0,0,0,1
3636,1.023552905575332,1163,4799,0,0,0,0,1
1372,1.023552905575332,2287,3659,0,0,0,0,1
3815,1.023552905575332,1015,4830,0,0,0,0,1
1054,1.023552905575332,2429,3483,0,0,0,0,1
2902,1.023552905575332,670,3572,0,0,0,0,1
1331,1.023552905575332,2313,3644,0,0,0,0,1
1289,1.023552905575332,2333,3622,0,0,0,0,1
2440,1.023552905575332,669,3109,0,0,0,0,1
2408,1.023552905575332,703,3111,0,0,0,0,1
1240,1.023552905575332,2356,3596,0,0,0,0,1
1249,1.023552905575332,2356,3605,0,0,0,0,1
3837,1.023552905575332,1040,4877,0,0,0,0,1
3514,1.023552905575332,1215,4729,0,0,0,0,1
2441,0.0984272769541661,684,3125,0,0,0,0,1
2435,1.023552905575332,662,3097,0,0,0,0,1
2457,1.023552905575332,654,3111,0,0,0,0,1
2446,1.023552905575332,665,3111,0,0,0,0,1
2004,1.023552905575332,1106,3110,0,0,0,0,1
2439,1.023552905575332,655,3094,0,0,0,0,1
1140,1.023552905575332,2418,3558,0,0,0,0,1
2894,1.023552905575332,660,3554,0,0,0,0,1
1558,1.023552905575332,1997,3555,0,0,0,0,1
1062,1.023552905575332,2421,3483,0,0,0,0,1
3454,1.023552905575332,1242,4696,0,0,0,0,1
3665,1.023552905575332,1133,4798,0,0,0,0,1
2426,1.023552905575332,669,3095,0,0,0,0,1
1235,1.023552905575332,2356,3591,0,0,0,0,1
2443,1.023552905575332,653,3096,0,0,0,0,1
3568,1.023552905575332,1212,4780,0,0,0,0,1
1139,1.023552905575332,2419,3558,0,0,0,0,1
3541,1.023552905575332,1213,4754,0,0,0,0,1
3325,1.023552905575332,1113,4438,0,0,0,0,1
2443,1.023552905575332,654,3097,0,0,0,0,1
3688,1.023552905575332,1132,4820,0,0,0,0,1
3646,1.023552905575332,1152,4798,0,0,0,0,1
3635,1.023552905575332,1163,4798,0,0,0,0,1
1429,1.023552905575332,2255,3684,0,0,0,0,1
1053,1.023552905575332,2429,3482,0,0,0,0,1
3230,1.023552905575332,1155,4385,0,0,0,0,1
1654,1.023552905575332,1943,3597,0,0,0,0,1
2901,1.023552905575332,670,3571,0,0,0,0,1
1032,1.023552905575332,2425,3457,0,0,0,0,1
3351,0.08787884938190683,1090,4441,0,0,0,0,1
2439,1.023552905575332,669,3108,0,0,0,0,1
3746,1.023552905575332,1115,4861,0,0,0,0,1
1219,1.023552905575332,2386,3605,0,0,0,0,1
1134,1.023552905575332,2419,3553,0,0,0,0,1
3325,1.023552905575332,1112,4437,0,0,0,0,1
3834,1.023552905575332,1042,4876,0,0,0,0,1
1172,1.023552905575332,2381,3553,0,0,0,0,1
1240,1.023552905575332,2363,3603,0,0,0,0,1
1202,1.023552905575332,2375,3577,0,0,0,0,1
1139,1.023552905575332,2418,3557,0,0,0,0,1
1557,1.023552905575332,1997,3554,0,0,0,0,1
2878,1.023552905575332,670,3548,0,0,0,0,1
1061,1.023552905575332,2421,3482,0,0,0,0,1
3453,1.023552905575332,1242,4695,0,0,0,0,1
1191,1.023552905575332,2387,3578,0,0,0,0,1
1049,1.023552905575332,2435,3484,0,0,0,0,1
1243,1.023552905575332,2356,3599,0,0,0,0,1
2442,1.023552905575332,653,3095,0,0,0,0,1
3567,1.023552905575332,1212,4779,0,0,0,0,1
3829,1.023552905575332,1042,4871,0,0,0,0,1
3329,1.023552905575332,1112,4441,0,0,0,0,1
1048,6.448257921457527e-06,2436,3484,0,0,0,0,1
1267,1.023552905575332,2329,3596,0,0,0,0,1
1143,1.023552905575332,2418,3561,0,0,0,0,1
1316,1.023552905575332,2339,3655,0,0,0,0,1
1428,1.023552905575332,2255,3683,0,0,0,0,1
1652,1.023552905575332,1945,3597,0,0,0,0,1
2900,1.023552905575332,670,3570,0,0,0,0,1
1220,1.023552905575332,2356,3576,0,0,0,0,1
1106,1.023552905575332,2419,3525,0,0,0,0,1
3685,1.023552905575332,1135,4820,0,0,0,0,1
1172,1.023552905575332,2380,3552,0,0,0,0,1
3694,1.023552905575332,1135,4829,0,0,0,0,1
1238,1.023552905575332,2356,3594,0,0,0,0,1
3745,1.023552905575332,1115,4860,0,0,0,0,1
1343,1.023552905575332,2312,3655,0,0,0,0,1
3817,1.023552905575332,1013,4830,0,0,0,0,1
3833,1.023552905575332,1042,4875,0,0,0,0,1
2007,1.023552905575332,1104,3111,0,0,0,0,1
3510,1.023552905575332,1217,4727,0,0,0,0,1
1264,1.023552905575332,2332,3596,0,0,0,0,1
1555,1.023552905575332,1999,3554,0,0,0,0,1
1048,1.023552905575332,2434,3482,0,0,0,0,1
2897,1.023552905575332,659,3556,0,0,0,0,1
2886,1.023552905575332,670,3556,0,0,0,0,1
1248,1.023552905575332,2355,3603,0,0,0,0,1
1216,1.023552905575332,2389,3605,0,0,0,0,1
1058,1.023552905575332,2423,3481,0,0,0,0,1
1048,1.023552905575332,2435,3483,0,0,0,0,1
1199,1.023552905575332,2378,3577,0,0,0,0,1
1347,1.023552905575332,2312,3659,0,0,0,0,1
3639,1.023552905575332,1161,4800,0,0,0,0,1
3565,1.023552905575332,1215,4780,0,0,0,0,1
3828,1.023552905575332,1042,4870,0,0,0,0,1
3328,1.023552905575332,1112,4440,0,0,0,0,1
2429,1.023552905575332,668,3097,0,0,0,0,1
1374,1.023552905575332,2285,3659,0,0,0,0,1
3603,1.023552905575332,1177,4780,0,0,0,0,1
3852,1.023552905575332,1015,4867,0,0,0,0,1
1315,1.023552905575332,2339,3654,0,0,0,0,1
1651,1.023552905575332,1945,3596,0,0,0,0,1
2442,1.023552905575332,1331,3773,0,0,0,0,1
1291,1.023552905575332,2331,3622,0,0,0,0,1
3233,1.023552905575332,1154,4387,0,0,0,0,1
1219,1.023552905575332,2356,3575,0,0,0,0,1
1245,1.023552905575332,2358,3603,0,0,0,0,1
1333,1.023552905575332,2312,3645,0,0,0,0,1
1028,1.023552905575332,2427,3455,0,0,0,0,1
1342,1.023552905575332,2312,3654,0,0,0,0,1
3634,1.023552905575332,1161,4795,0,0,0,0,1
3823,1.023552905575332,1042,4865,0,0,0,0,1
3643,1.023552905575332,1161,4804,0,0,0,0,1
2442,1.023552905575332,667,3109,0,0,0,0,1
1561,1.023552905575332,1995,3556,0,0,0,0,1
3837,0.00018491691640272278,1041,4878,0,0,0,0,1
3670,1.023552905575332,1161,4831,0,0,0,0,1
3457,1.023552905575332,1240,4697,0,0,0,0,1
1319,1.023552905575332,2338,3657,0,0,0,0,1
1283,1.023552905575332,2339,3622,0,0,0,0,1
3619,1.023552905575332,1154,4773,0,0,0,0,1
1495,1.023552905575332,2034,3529,0,0,0,0,1
1188,1.023552905575332,2389,3577,0,0,0,0,1
3875,0.0063440627290650385,1003,4878,0,0,0,0,1
3697,1.023552905575332,1134,4831,0,0,0,0,1
1630,1.023552905575332,1967,3597,0,0,0,0,1
1057,1.023552905575332,2423,3480,0,0,0,0,1
3326,1.023552905575332,1114,4440,0,0,0,0,1
3638,1.023552905575332,1161,4799,0,0,0,0,1
3823,1.023552905575332,1041,4864,0,0,0,0,1
3832,1.023552905575332,1041,4873,0,0,0,0,1
1558,1.023552905575332,1998,3556,0,0,0,0,1
3648,1.023552905575332,1150,4798,0,0,0,0,1
1314,1.023552905575332,2338,3652,0,0,0,0,1
1062,1.023552905575332,2422,3484,0,0,0,0,1
1095,0.009024237196656917,2436,3531,0,0,0,0,1
1431,1.023552905575332,2253,3684,0,0,0,0,1
2410,1.023552905575332,701,3111,0,0,0,0,1
1251,1.023552905575332,2354,3605,0,0,0,0,1
3641,1.023552905575332,1154,4795,0,0,0,0,1
3389,1.023552905575332,1087,4476,0,0,0,0,1
3591,1.023552905575332,1180,4771,0,0,0,0,1
1522,1.023552905575332,2033,3555,0,0,0,0,1
2476,1.023552905575332,669,3145,0,0,0,0,1
2903,1.023552905575332,669,3572,0,0,0,0,1
3600,1.023552905575332,1180,4780,0,0,0,0,1
1027,1.023552905575332,2427,3454,0,0,0,0,1
1066,1.023552905575332,2389,3455,0,0,0,0,1
1282,1.023552905575332,2338,3620,0,0,0,0,1
2448,1.023552905575332,655,3103,0,0,0,0,1
1560,1.023552905575332,1995,3555,0,0,0,0,1
3836,1.023552905575332,1041,4877,0,0,0,0,1
3513,1.023552905575332,1216,4729,0,0,0,0,1
1053,1.023552905575332,2430,3483,0,0,0,0,1
3855,1.023552905575332,1014,4869,0,0,0,0,1
3618,1.023552905575332,1154,4772,0,0,0,0,1
1169,1.023552905575332,2389,3558,0,0,0,0,1
3390,1.023552905575332,1086,4476,0,0,0,0,1
3695,1.023552905575332,1136,4831,0,0,0,0,1
1982,1.023552905575332,1130,3112,0,0,0,0,1
3570,1.023552905575332,1210,4780,0,0,0,0,1
1187,1.023552905575332,2389,3576,0,0,0,0,1
1141,1.023552905575332,2417,3558,0,0,0,0,1
3543,1.023552905575332,1211,4754,0,0,0,0,1
1196,1.023552905575332,2389,3585,0,0,0,0,1
1051,1.023552905575332,2433,3484,0,0,0,0,1
1092,1.023552905575332,2440,3532,0,0,0,0,1
2445,1.023552905575332,652,3097,0,0,0,0,1
2434,1.023552905575332,663,3097,0,0,0,0,1
3595,1.023552905575332,1180,4775,0,0,0,0,1
3325,1.023552905575332,1114,4439,0,0,0,0,1
3694,1.023552905575332,1137,4831,0,0,0,0,1
3637,1.023552905575332,1161,4798,0,0,0,0,1
3280,1.023552905575332,1129,4409,0,0,0,0,1
3822,1.023552905575332,1041,4863,0,0,0,0,1
2443,1.023552905575332,655,3098,0,0,0,0,1
3831,1.023552905575332,1041,4872,0,0,0,0,1
1371,1.023552905575332,2287,3658,0,0,0,0,1
1557,1.023552905575332,1998,3555,0,0,0,0,1
1061,1.023552905575332,2422,3483,0,0,0,0,1
1145,1.023552905575332,2416,3561,0,0,0,0,1
3664,1.023552905575332,1134,4798,0,0,0,0,1
3387,1.023552905575332,1089,4476,0,0,0,0,1
3572,1.023552905575332,1180,4752,0,0,0,0,1
3696,1.023552905575332,1133,4829,0,0,0,0,1
3836,1.023552905575332,1040,4876,0,0,0,0,1
1288,1.023552905575332,2334,3622,0,0,0,0,1
2475,1.023552905575332,669,3144,0,0,0,0,1
3599,1.023552905575332,1180,4779,0,0,0,0,1
1248,1.023552905575332,2357,3605,0,0,0,0,1
1317,1.023552905575332,2337,3654,0,0,0,0,1
1281,1.023552905575332,2338,3619,0,0,0,0,1
3624,1.023552905575332,1150,4774,0,0,0,0,1
2880,1.023552905575332,668,3548,0,0,0,0,1
2456,1.023552905575332,655,3111,0,0,0,0,1
2445,1.023552905575332,666,3111,0,0,0,0,1
3666,1.023552905575332,1163,4829,0,0,0,0,1
3261,1.023552905575332,1155,4416,0,0,0,0,1
1250,1.023552905575332,2353,3603,0,0,0,0,1
1218,1.023552905575332,2387,3605,0,0,0,0,1
3831,1.023552905575332,1040,4871,0,0,0,0,1
1138,1.023552905575332,2419,3557,0,0,0,0,1
3324,1.023552905575332,1113,4437,0,0,0,0,1
3594,1.023552905575332,1180,4774,0,0,0,0,1
1285,1.023552905575332,2337,3622,0,0,0,0,1
2442,1.023552905575332,654,3096,0,0,0,0,1
3567,1.023552905575332,1213,4780,0,0,0,0,1
3712,1.023552905575332,1110,4822,0,0,0,0,1
2442,1.023552905575332,655,3097,0,0,0,0,1
3634,1.023552905575332,1163,4797,0,0,0,0,1
1370,1.023552905575332,2287,3657,0,0,0,0,1
3826,1.023552905575332,1039,4865,0,0,0,0,1
1653,1.023552905575332,1943,3596,0,0,0,0,1
2438,1.023552905575332,669,3107,0,0,0,0,1
1247,1.023552905575332,2356,3603,0,0,0,0,1
1989,1.023552905575332,1113,3102,0,0,0,0,1
3377,0.0845600993063733,1090,4467,0,0,0,0,1
1142,1.023552905575332,2419,3561,0,0,0,0,1
3328,1.023552905575332,1113,4441,0,0,0,0,1
1998,1.023552905575332,1114,3112,0,0,0,0,1
1266,1.023552905575332,2330,3596,0,0,0,0,1
3537,1.023552905575332,1217,4754,0,0,0,0,1
1056,1.023552905575332,2428,3484,0,0,0,0,1
3744,1.023552905575332,1116,4860,0,0,0,0,1
1069,1.023552905575332,2388,3457,0,0,0,0,1
1623,1.023552905575332,1974,3597,0,0,0,0,1
1201,1.023552905575332,2376,3577,0,0,0,0,1
1190,1.023552905575332,2387,3577,0,0,0,0,1
3642,1.023552905575332,1156,4798,0,0,0,0,1
2442,1.023552905575332,669,3111,0,0,0,0,1
1242,1.023552905575332,2356,3598,0,0,0,0,1
3830,1.023552905575332,1040,4870,0,0,0,0,1
1194,1.023552905575332,2380,3574,0,0,0,0,1
3323,1.023552905575332,1113,4436,0,0,0,0,1
3725,1.023552905575332,1135,4860,0,0,0,0,1
2441,1.023552905575332,654,3095,0,0,0,0,1
1047,0.0001380263637062821,2436,3483,0,0,0,0,1
2006,1.023552905575332,1106,3112,0,0,0,0,1
3633,1.023552905575332,1163,4796,0,0,0,0,1
3456,1.023552905575332,1241,4697,0,0,0,0,1
1133,1.023552905575332,2418,3551,0,0,0,0,1
3642,1.023552905575332,1163,4805,0,0,0,0,1
1293,1.023552905575332,2329,3622,0,0,0,0,1
3349,0.08362581514442856,1089,4438,0,0,0,0,1
1427,1.023552905575332,2255,3682,0,0,0,0,1
2428,1.023552905575332,669,3097,0,0,0,0,1
1171,1.023552905575332,2380,3551,0,0,0,0,1
1246,1.023552905575332,2356,3602,0,0,0,0,1
1132,1.023552905575332,2419,3551,0,0,0,0,1
2443,0.09871472783211067,683,3126,0,0,0,0,1
1988,1.023552905575332,1114,3102,0,0,0,0,1
1055,1.023552905575332,2428,3483,0,0,0,0,1
2006,1.023552905575332,1105,3111,0,0,0,0,1
3857,1.023552905575332,1012,4869,0,0,0,0,1
3690,1.023552905575332,1132,4822,0,0,0,0,1
3637,1.023552905575332,1163,4800,0,0,0,0,1
1312,1.023552905575332,2310,3622,0,0,0,0,1
1290,1.023552905575332,2332,3622,0,0,0,0,1
3232,1.023552905575332,1155,4387,0,0,0,0,1
1047,1.023552905575332,2435,3482,0,0,0,0,1
1332,1.023552905575332,2313,3645,0,0,0,0,1
2436,1.023552905575332,661,3097,0,0,0,0,1
2458,1.023552905575332,653,3111,0,0,0,0,1
1560,1.023552905575332,1996,3556,0,0,0,0,1
3327,1.023552905575332,1112,4439,0,0,0,0,1
3836,1.0881695721863249e-05,1042,4878,0,0,0,0,1
1426,1.023552905575332,2255,3681,0,0,0,0,1
3750,1.023552905575332,1111,4861,0,0,0,0,1
3542,1.023552905575332,1212,4754,0,0,0,0,1
3683,1.023552905575332,1135,4818,0,0,0,0,1
2427,1.023552905575332,669,3096,0,0,0,0,1
1061,1.023552905575332,2423,3484,0,0,0,0,1
1243,1.023552905575332,2353,3596,0,0,0,0,1
1236,1.023552905575332,2356,3592,0,0,0,0,1
2444,1.023552905575332,653,3097,0,0,0,0,1
3569,1.023552905575332,1212,4781,0,0,0,0,1
3553,1.023552905575332,1202,4755,0,0,0,0,1
3822,1.023552905575332,1042,4864,0,0,0,0,1
2442,0.06205363996531117,683,3125,0,0,0,0,1
1195,1.023552905575332,2382,3577,0,0,0,0,1
3647,1.023552905575332,1151,4798,0,0,0,0,1
1430,1.023552905575332,2254,3684,0,0,0,0,1
1054,1.023552905575332,2428,3482,0,0,0,0,1
2441,1.023552905575332,668,3109,0,0,0,0,1
1984,1.023552905575332,1128,3112,0,0,0,0,1
1262,1.023552905575332,2332,3594,0,0,0,0,1
3741,1.023552905575332,1119,4860,0,0,0,0,1
1188,1.023552905575332,2387,3575,0,0,0,0,1
1214,1.023552905575332,2389,3603,0,0,0,0,1
3687,1.023552905575332,1135,4822,0,0,0,0,1
3696,1.023552905575332,1135,4831,0,0,0,0,1
1345,1.023552905575332,2312,3657,0,0,0,0,1
1009,0.005417650334728739,2436,3445,0,0,0,0,1
1559,1.023552905575332,1996,3555,0,0,0,0,1
3835,1.023552905575332,1042,4877,0,0,0,0,1
3512,1.023552905575332,1217,4729,0,0,0,0,1
3454,1.023552905575332,1241,4695,0,0,0,0,1
1557,1.023552905575332,1999,3556,0,0,0,0,1
1313,1.023552905575332,2339,3652,0,0,0,0,1
1050,1.023552905575332,2434,3484,0,0,0,0,1
3640,1.023552905575332,1154,4794,0,0,0,0,1
3231,1.023552905575332,1154,4385,0,0,0,0,1
2409,1.023552905575332,702,3111,0,0,0,0,1
1250,1.023552905575332,2355,3605,0,0,0,0,1
3682,1.023552905575332,1135,4817,0,0,0,0,1
1060,1.023552905575332,2423,3483,0,0,0,0,1
3388,1.023552905575332,1088,4476,0,0,0,0,1
1026,1.023552905575332,2427,3453,0,0,0,0,1
1536,0.08789130161265667,1996,3532,0,0,0,0,1
3821,1.023552905575332,1042,4863,0,0,0,0,1
3713,1.023552905575332,1118,4831,0,0,0,0,1
1559,1.023552905575332,1995,3554,0,0,0,0,1
3835,1.023552905575332,1041,4876,0,0,0,0,1
3668,1.023552905575332,1161,4829,0,0,0,0,1
1317,1.023552905575332,2338,3655,0,0,0,0,1
1261,1.023552905575332,2332,3593,0,0,0,0,1
3617,1.023552905575332,1154,4771,0,0,0,0,1
1241,1.023552905575332,2362,3603,0,0,0,0,1
1052,1.023552905575332,2431,3483,0,0,0,0,1
1981,1.023552905575332,1130,3111,0,0,0,0,1
3854,1.023552905575332,1015,4869,0,0,0,0,1
1186,1.023552905575332,2389,3575,0,0,0,0,1
3644,1.023552905575332,1154,4798,0,0,0,0,1
3695,1.023552905575332,1134,4829,0,0,0,0,1
1091,1.023552905575332,2440,3531,0,0,0,0,1
2879,1.023552905575332,669,3548,0,0,0,0,1
1196,1.023552905575332,2378,3574,0,0,0,0,1
1247,1.023552905575332,2358,3605,0,0,0,0,1
1068,1.023552905575332,2415,3483,0,0,0,0,1
1030,1.023552905575332,2427,3457,0,0,0,0,1
3636,1.023552905575332,1161,4797,0,0,0,0,1
3623,1.023552905575332,1151,4774,0,0,0,0,1
2444,1.023552905575332,667,3111,0,0,0,0,1
3830,1.023552905575332,1041,4871,0,0,0,0,1
1556,1.023552905575332,1998,3554,0,0,0,0,1
1060,1.023552905575332,2422,3482,0,0,0,0,1
1556,1.023552905575332,1999,3555,0,0,0,0,1
1249,1.023552905575332,2354,3603,0,0,0,0,1
1049,1.023552905575332,2434,3483,0,0,0,0,1
1190,1.023552905575332,2389,3579,0,0,0,0,1
1144,1.023552905575332,2417,3561,0,0,0,0,1
3386,1.023552905575332,1090,4476,0,0,0,0,1
1059,1.023552905575332,2423,3482,0,0,0,0,1
2474,1.023552905575332,669,3143,0,0,0,0,1
1025,1.023552905575332,2427,3452,0,0,0,0,1
3539,1.023552905575332,1215,4754,0,0,0,0,1
1990,1.023552905575332,1112,3102,0,0,0,0,1
2430,1.023552905575332,667,3097,0,0,0,0,1
3816,1.023552905575332,1041,4857,0,0,0,0,1
2455,1.023552905575332,655,3110,0,0,0,0,1
1316,1.023552905575332,2338,3654,0,0,0,0,1
3690,1.023552905575332,1141,4831,0,0,0,0,1
3665,1.023552905575332,1163,4828,0,0,0,0,1
1265,1.023552905575332,2331,3596,0,0,0,0,1
1980,1.023552905575332,1130,3110,0,0,0,0,1
1185,1.023552905575332,2389,3574,0,0,0,0,1
1194,1.023552905575332,2389,3583,0,0,0,0,1
1090,1.023552905575332,2440,3530,0,0,0,0,1
2878,1.023552905575332,669,3547,0,0,0,0,1
3593,1.023552905575332,1180,4773,0,0,0,0,1
1029,1.023552905575332,2427,3456,0,0,0,0,1
3323,1.023552905575332,1114,4437,0,0,0,0,1
3635,1.023552905575332,1161,4796,0,0,0,0,1
3458,1.023552905575332,1239,4697,0,0,0,0,1
3644,1.023552905575332,1161,4805,0,0,0,0,1
1284,1.023552905575332,2338,3622,0,0,0,0,1
2441,1.023552905575332,655,3096,0,0,0,0,1
3829,1.023552905575332,1041,4870,0,0,0,0,1
2450,1.023552905575332,655,3105,0,0,0,0,1
2896,1.023552905575332,660,3556,0,0,0,0,1
3620,1.023552905575332,1154,4774,0,0,0,0,1
1171,1.023552905575332,2389,3560,0,0,0,0,1
1604,1.023552905575332,1967,3571,0,0,0,0,1
1189,1.023552905575332,2389,3578,0,0,0,0,1
3825,1.023552905575332,1040,4865,0,0,0,0,1
3327,1.023552905575332,1113,4440,0,0,0,0,1
3538,1.023552905575332,1215,4753,0,0,0,0,1
1246,1.023552905575332,2357,3603,0,0,0,0,1
3327,1.023552905575332,1114,4441,0,0,0,0,1
