struct_elem,sw_part,start1,end1,start2,end2,start3,end3,type
3840,1.023552905575332,1583,5423,0,0,0,0,1
3838,1.023552905575332,1594,5432,0,0,0,0,1
3228,1.023552905575332,2264,5492,0,0,0,0,1
3883,1.023552905575332,1552,5435,0,0,0,0,1
2518,1.023552905575332,2247,4765,0,0,0,0,1
1949,1.023552905575332,2530,4479,0,0,0,0,1
4408,1.023552905575332,1300,5708,0,0,0,0,1
1685,0.04346150626958943,3124,4809,0,0,0,0,1
1992,1.023552905575332,2499,4491,0,0,0,0,1
4607,1.023552905575332,1214,5821,0,0,0,0,1
4950,1.023552905575332,927,5877,0,0,0,0,1
4977,1.023552905575332,986,5963,0,0,0,0,1
2477,1.023552905575332,2256,4733,0,0,0,0,1
3184,1.023552905575332,2296,5480,0,0,0,0,1
4408,1.023552905575332,1301,5709,0,0,0,0,1
4210,1.023552905575332,1402,5612,0,0,0,0,1
2355,1.023552905575332,2334,4689,0,0,0,0,1
2397,1.023552905575332,2314,4711,0,0,0,0,1
4297,1.023552905575332,1340,5637,0,0,0,0,1
1509,1.023552905575332,2764,4273,0,0,0,0,1
3227,1.023552905575332,2265,5492,0,0,0,0,1
1673,1.023552905575332,2667,4340,0,0,0,0,1
4981,1.023552905575332,1011,5992,0,0,0,0,1
3970,1.023552905575332,1524,5494,0,0,0,0,1
4414,1.023552905575332,1297,5711,0,0,0,0,1
1365,1.023552905575332,2764,4129,0,0,0,0,1
1758,1.023552905575332,2635,4393,0,0,0,0,1
3774,21.817876557971935,1629,5403,0,0,0,0,1
2126,1.023552905575332,2432,4558,0,0,0,0,1
4538,1.023552905575332,1242,5780,0,0,0,0,1
2410,1.023552905575332,2313,4723,0,0,0,0,1
2451,1.023552905575332,2279,4730,0,0,0,0,1
1748,225.1968185574723,3062,4810,0,0,0,0,1
3988,1.023552905575332,1471,5459,0,0,0,0,1
3204,1.023552905575332,2298,5502,0,0,0,0,1
2377,1.023552905575332,2307,4684,0,0,0,0,1
3178,1.023552905575332,2254,5432,0,0,0,0,1
1380,1.023552905575332,2785,4165,0,0,0,0,1
4668,1.023552905575332,1183,5851,0,0,0,0,1
2227,14.76042591769306,2628,4855,0,0,0,0,1
2064,1.023552905575332,2456,4520,0,0,0,0,1
2387,11.371815190376946,2313,4700,0,0,0,0,1
3178,1.023552905575332,2255,5433,0,0,0,0,1
2347,1.023552905575332,2304,4651,0,0,0,0,1
2551,1.023552905575332,2216,4767,0,0,0,0,1
2190,22.042567674932204,2403,4593,0,0,0,0,1
1392,0.024952504548305582,2460,3852,0,0,0,0,1
4602,1.023552905575332,1213,5815,0,0,0,0,1
3160,1.023552905575332,3000,6160,0,0,0,0,1
2190,16.408273548724022,2404,4594,0,0,0,0,1
2515,1.023552905575332,2251,4766,0,0,0,0,1
4849,1.023552905575332,1095,5944,0,0,0,0,1
3841,1.023552905575332,1593,5434,0,0,0,0,1
4290,0.003344143939469323,1351,5641,0,0,0,0,1
3207,9.99634395043595,1603,4810,0,0,0,0,1
2481,1.023552905575332,2255,4736,0,0,0,0,1
4371,1.023552905575332,1308,5679,0,0,0,0,1
1952,1.023552905575332,2529,4481,0,0,0,0,1
2358,1.023552905575332,2332,4690,0,0,0,0,1
1652,12.966276531197328,3124,4776,0,0,0,0,1
2560,0.08575500475962679,2223,4783,0,0,0,0,1
2033,1.023552905575332,2486,4519,0,0,0,0,1
3809,1.023552905575332,1587,5396,0,0,0,0,1
4980,1.023552905575332,985,5965,0,0,0,0,1
2396,0.08862951051430855,2321,4717,0,0,0,0,1
4411,1.023552905575332,1300,5711,0,0,0,0,1
2480,1.023552905575332,2256,4736,0,0,0,0,1
1761,1.023552905575332,2633,4394,0,0,0,0,1
1923,1.023552905575332,2533,4456,0,0,0,0,1
4300,1.023552905575332,1340,5640,0,0,0,0,1
1841,1.023552905575332,2602,4443,0,0,0,0,1
3899,10.46990603569479,1536,5435,0,0,0,0,1
4341,1.023552905575332,1338,5679,0,0,0,0,1
2371,1.023552905575332,2317,4688,0,0,0,0,1
1963,1.023552905575332,2525,4488,0,0,0,0,1
2375,1.023552905575332,2309,4684,0,0,0,0,1
2448,1.023552905575332,2282,4730,0,0,0,0,1
4989,1.023552905575332,1010,5999,0,0,0,0,1
4968,1.023552905575332,914,5882,0,0,0,0,1
2377,13.079884573560026,2313,4690,0,0,0,0,1
2573,1.023552905575332,2223,4796,0,0,0,0,1
3171,0.0045940053587189365,2265,5436,0,0,0,0,1
3187,0.051784592224556385,1596,4783,0,0,0,0,1
3134,1.023552905575332,2310,5444,0,0,0,0,1
2061,1.023552905575332,2459,4520,0,0,0,0,1
2462,0.09879642542487094,2314,4776,0,0,0,0,1
2344,1.023552905575332,2307,4651,0,0,0,0,1
3956,0.056986909268757636,1537,5493,0,0,0,0,1
2548,1.023552905575332,2219,4767,0,0,0,0,1
3132,0.059015951059399566,2322,5454,0,0,0,0,1
1950,1.023552905575332,2531,4481,0,0,0,0,1
1991,1.023552905575332,2497,4488,0,0,0,0,1
3955,1.023552905575332,1538,5493,0,0,0,0,1
3838,1.023552905575332,1596,5434,0,0,0,0,1
4132,29.64467311816081,1676,5808,0,0,0,0,1
3210,1.023552905575332,2980,6190,0,0,0,0,1
2342,1.023552905575332,2243,4585,0,0,0,0,1
1960,1.023552905575332,2528,4488,0,0,0,0,1
1637,1.023552905575332,2703,4340,0,0,0,0,1
1401,1.023552905575332,2784,4185,0,0,0,0,1
4956,1.023552905575332,926,5882,0,0,0,0,1
3180,1.023552905575332,2977,6157,0,0,0,0,1
3177,1.023552905575332,1596,4773,0,0,0,0,1
1930,1.023552905575332,2524,4454,0,0,0,0,1
3178,1.023552905575332,1629,4807,0,0,0,0,1
3983,13.339838958033242,1510,5493,0,0,0,0,1
3209,1.023552905575332,2259,5468,0,0,0,0,1
3989,1.023552905575332,1473,5462,0,0,0,0,1
2341,1.023552905575332,2244,4585,0,0,0,0,1
1826,1.023552905575332,3030,4856,0,0,0,0,1
4611,1.023552905575332,1629,6240,0,0,0,0,1
2378,1.023552905575332,2309,4687,0,0,0,0,1
2461,10.435463136051842,2255,4716,0,0,0,0,1
4508,1.023552905575332,1241,5749,0,0,0,0,1
4550,1.023552905575332,1240,5790,0,0,0,0,1
3208,1.023552905575332,2260,5468,0,0,0,0,1
3787,1.023552905575332,1616,5403,0,0,0,0,1
1378,1.023552905575332,2784,4162,0,0,0,0,1
4395,1.023552905575332,1310,5705,0,0,0,0,1
3953,1.023552905575332,1540,5493,0,0,0,0,1
3154,10.36935767348869,1596,4750,0,0,0,0,1
1495,10.222356248084237,3061,4556,0,0,0,0,1
3155,10.573287062695991,1629,4784,0,0,0,0,1
3992,11.439884613380721,1517,5509,0,0,0,0,1
5045,1.023552905575332,985,6030,0,0,0,0,1
4722,1.023552905575332,1160,5882,0,0,0,0,1
4517,1.023552905575332,1266,5783,0,0,0,0,1
4722,1.023552905575332,1161,5883,0,0,0,0,1
4643,1.023552905575332,1207,5850,0,0,0,0,1
4805,1.023552905575332,1139,5944,0,0,0,0,1
1994,1.023552905575332,2496,4490,0,0,0,0,1
3923,16.870910246988007,1570,5493,0,0,0,0,1
2071,0.0009450791137568798,2461,4532,0,0,0,0,1
3200,1.023552905575332,2980,6180,0,0,0,0,1
4410,1.023552905575332,1298,5708,0,0,0,0,1
4020,1.023552905575332,1405,5425,0,0,0,0,1
1994,1.023552905575332,2497,4491,0,0,0,0,1
2156,1.023552905575332,2429,4585,0,0,0,0,1
3884,1.023552905575332,1550,5434,0,0,0,0,1
1950,1.023552905575332,2528,4478,0,0,0,0,1
4708,13.123573093953963,1596,6304,0,0,0,0,1
1410,1.023552905575332,2697,4107,0,0,0,0,1
1314,1.023552905575332,2851,4165,0,0,0,0,1
4016,1.023552905575332,1446,5462,0,0,0,0,1
2478,1.023552905575332,2280,4758,0,0,0,0,1
3922,14.127126767313511,1571,5493,0,0,0,0,1
2604,1.023552905575332,2195,4799,0,0,0,0,1
2375,1.023552905575332,2278,4653,0,0,0,0,1
3979,1.023552905575332,1506,5485,0,0,0,0,1
1366,1.023552905575332,2762,4128,0,0,0,0,1
3206,1.023552905575332,2262,5468,0,0,0,0,1
4264,0.07309385584096698,1376,5640,0,0,0,0,1
3784,1.023552905575332,1618,5402,0,0,0,0,1
2343,1.023552905575332,2305,4648,0,0,0,0,1
1370,1.023552905575332,2820,4190,0,0,0,0,1
4032,1.023552905575332,1482,5514,0,0,0,0,1
3911,1.023552905575332,1548,5459,0,0,0,0,1
4963,1.023552905575332,1001,5964,0,0,0,0,1
2547,1.023552905575332,2218,4765,0,0,0,0,1
1816,1.023552905575332,2601,4417,0,0,0,0,1
3172,1.023552905575332,2301,5473,0,0,0,0,1
1379,1.023552905575332,2812,4191,0,0,0,0,1
1780,1.023552905575332,2635,4415,0,0,0,0,1
3756,1.023552905575332,1619,5375,0,0,0,0,1
3918,1.023552905575332,1551,5469,0,0,0,0,1
3210,27.107667903686135,2322,5532,0,0,0,0,1
1948,1.023552905575332,2530,4478,0,0,0,0,1
4604,1.023552905575332,1211,5815,0,0,0,0,1
1991,1.023552905575332,2499,4490,0,0,0,0,1
2396,1.023552905575332,2314,4710,0,0,0,0,1
3226,1.023552905575332,2265,5491,0,0,0,0,1
4689,1.023552905575332,1161,5850,0,0,0,0,1
4851,1.023552905575332,1093,5944,0,0,0,0,1
4209,1.023552905575332,1403,5612,0,0,0,0,1
4982,1.023552905575332,982,5964,0,0,0,0,1
1954,1.023552905575332,2527,4481,0,0,0,0,1
1364,1.023552905575332,2764,4128,0,0,0,0,1
2360,18.552857681459066,2330,4690,0,0,0,0,1
1757,1.023552905575332,2635,4392,0,0,0,0,1
1672,1.023552905575332,2668,4340,0,0,0,0,1
1880,1.023552905575332,2572,4452,0,0,0,0,1
3773,27.97908469688663,1629,5402,0,0,0,0,1
4413,1.023552905575332,1298,5711,0,0,0,0,1
1880,1.023552905575332,2573,4453,0,0,0,0,1
4537,1.023552905575332,1242,5779,0,0,0,0,1
2326,1.023552905575332,2335,4661,0,0,0,0,1
1763,1.023552905575332,2631,4394,0,0,0,0,1
2409,1.023552905575332,2313,4722,0,0,0,0,1
3976,1.023552905575332,1509,5485,0,0,0,0,1
4343,1.023552905575332,1336,5679,0,0,0,0,1
4430,1.023552905575332,1274,5704,0,0,0,0,1
4227,1.023552905575332,1383,5610,0,0,0,0,1
4993,1.023552905575332,1011,6004,0,0,0,0,1
2136,1.023552905575332,2428,4564,0,0,0,0,1
3990,1.023552905575332,1508,5498,0,0,0,0,1
4667,1.023552905575332,1183,5850,0,0,0,0,1
1857,1.023552905575332,2573,4430,0,0,0,0,1
3908,1.023552905575332,1551,5459,0,0,0,0,1
4960,1.023552905575332,1004,5964,0,0,0,0,1
3177,1.023552905575332,2255,5432,0,0,0,0,1
1813,1.023552905575332,2604,4417,0,0,0,0,1
4071,1.023552905575332,1466,5537,0,0,0,0,1
2386,13.653553495932059,2314,4700,0,0,0,0,1
3989,1.023552905575332,1509,5498,0,0,0,0,1
2346,1.023552905575332,2305,4651,0,0,0,0,1
2550,1.023552905575332,2217,4767,0,0,0,0,1
2189,12.220143026285404,2404,4593,0,0,0,0,1
4052,1.023552905575332,1618,5670,0,0,0,0,1
3173,0.10176249456652504,2329,5502,0,0,0,0,1
3159,1.023552905575332,3001,6160,0,0,0,0,1
3840,1.023552905575332,1593,5433,0,0,0,0,1
1951,1.023552905575332,2529,4480,0,0,0,0,1
4843,1.023552905575332,1097,5940,0,0,0,0,1
3957,0.04765623788103124,1536,5493,0,0,0,0,1
4003,1.023552905575332,1508,5511,0,0,0,0,1
3840,1.023552905575332,1594,5434,0,0,0,0,1
3844,1.023552905575332,1586,5430,0,0,0,0,1
3230,1.023552905575332,2264,5494,0,0,0,0,1
4329,0.06658705444094679,1311,5640,0,0,0,0,1
4979,1.023552905575332,985,5964,0,0,0,0,1
2395,0.08098079231740106,2321,4716,0,0,0,0,1
3190,0.0022646933501330887,2255,5445,0,0,0,0,1
4410,1.023552905575332,1300,5710,0,0,0,0,1
1401,1.023552905575332,2726,4127,0,0,0,0,1
3154,1.023552905575332,2288,5442,0,0,0,0,1
1511,1.023552905575332,2763,4274,0,0,0,0,1
4609,1.023552905575332,1214,5823,0,0,0,0,1
4979,1.023552905575332,986,5965,0,0,0,0,1
4410,1.023552905575332,1301,5711,0,0,0,0,1
4299,1.023552905575332,1340,5639,0,0,0,0,1
3229,10155932.35354148,2265,5494,0,0,0,0,1
1367,1.023552905575332,2763,4130,0,0,0,0,1
4013,1.023552905575332,1471,5484,0,0,0,0,1
1414,1.023552905575332,2692,4106,0,0,0,0,1
1962,1.023552905575332,2526,4488,0,0,0,0,1
1639,1.023552905575332,2701,4340,0,0,0,0,1
4540,1.023552905575332,1241,5781,0,0,0,0,1
2368,11.570008574235844,2329,4697,0,0,0,0,1
3179,1.023552905575332,1594,4773,0,0,0,0,1
2453,1.023552905575332,2278,4731,0,0,0,0,1
2529,14.034933579301264,2255,4784,0,0,0,0,1
4956,1.023552905575332,986,5942,0,0,0,0,1
2376,13.675307532806631,2314,4690,0,0,0,0,1
3131,0.07615617757424795,2322,5453,0,0,0,0,1
3945,1.023552905575332,1546,5491,0,0,0,0,1
2547,1.023552905575332,2220,4767,0,0,0,0,1
3180,1.023552905575332,2254,5434,0,0,0,0,1
4476,1.023552905575332,1276,5752,0,0,0,0,1
3954,1.023552905575332,1538,5492,0,0,0,0,1
3180,1.023552905575332,2287,5467,0,0,0,0,1
3837,1.023552905575332,1596,5433,0,0,0,0,1
1948,1.023552905575332,2532,4480,0,0,0,0,1
4131,30.98561929960271,1676,5807,0,0,0,0,1
4604,1.023552905575332,1213,5817,0,0,0,0,1
2517,1.023552905575332,2250,4767,0,0,0,0,1
4806,1.023552905575332,1137,5943,0,0,0,0,1
4022,1.023552905575332,1403,5425,0,0,0,0,1
3209,1.023552905575332,2980,6189,0,0,0,0,1
3843,1.023552905575332,1593,5436,0,0,0,0,1
2521,1.023552905575332,2243,4764,0,0,0,0,1
1750,1.023552905575332,2635,4385,0,0,0,0,1
2519,1.023552905575332,2254,4773,0,0,0,0,1
1716,1.023552905575332,2671,4387,0,0,0,0,1
1757,1.023552905575332,2637,4394,0,0,0,0,1
1636,1.023552905575332,2703,4339,0,0,0,0,1
1400,1.023552905575332,2784,4184,0,0,0,0,1
2364,1.023552905575332,2325,4689,0,0,0,0,1
4955,1.023552905575332,927,5882,0,0,0,0,1
1929,1.023552905575332,2525,4454,0,0,0,0,1
4343,1.023552905575332,1338,5681,0,0,0,0,1
2377,1.023552905575332,2309,4686,0,0,0,0,1
4507,1.023552905575332,1241,5748,0,0,0,0,1
3786,1.023552905575332,1616,5402,0,0,0,0,1
3213,14.983325118162163,2223,5436,0,0,0,0,1
2496,0.08638365505821916,2255,4751,0,0,0,0,1
4507,1.023552905575332,1242,5749,0,0,0,0,1
1372,1.023552905575332,2818,4190,0,0,0,0,1
1795,0.08030293288705477,3061,4856,0,0,0,0,1
4721,1.023552905575332,1161,5882,0,0,0,0,1
3153,9.866760692385943,1630,4783,0,0,0,0,1
3199,1.023552905575332,2980,6179,0,0,0,0,1
1993,1.023552905575332,2497,4490,0,0,0,0,1
3883,1.023552905575332,1550,5433,0,0,0,0,1
2552,0.06555052761402778,2223,4775,0,0,0,0,1
4409,1.023552905575332,1299,5708,0,0,0,0,1
3840,15834.639471764696,1596,5436,0,0,0,0,1
1409,1.023552905575332,2698,4107,0,0,0,0,1
2603,1.023552905575332,2195,4798,0,0,0,0,1
4990,1.023552905575332,950,5940,0,0,0,0,1
3194,1.023552905575332,2301,5495,0,0,0,0,1
2374,1.023552905575332,2279,4653,0,0,0,0,1
3978,1.023552905575332,1507,5485,0,0,0,0,1
1881,1.023552905575332,2571,4452,0,0,0,0,1
1962,1.023552905575332,2528,4490,0,0,0,0,1
1749,263.3432865036743,3061,4810,0,0,0,0,1
3179,0.0025947570885196014,1596,4775,0,0,0,0,1
4263,0.09092096627186455,1377,5640,0,0,0,0,1
1932,1.023552905575332,2524,4456,0,0,0,0,1
3180,0.0002772666359986022,1629,4809,0,0,0,0,1
3182,1.023552905575332,2977,6159,0,0,0,0,1
3124,185789.36623771922,2321,5445,0,0,0,0,1
2410,1.023552905575332,2312,4722,0,0,0,0,1
2097,0.09099500947982843,2460,4557,0,0,0,0,1
3710,27.944833178299522,1629,5339,0,0,0,0,1
4613,490.0677976783447,1629,6242,0,0,0,0,1
1817,1.023552905575332,2605,4422,0,0,0,0,1
2228,14.830174017972762,2627,4855,0,0,0,0,1
1819,1.023552905575332,2627,4446,0,0,0,0,1
2313,0.07286630012947955,3123,5436,0,0,0,0,1
4961,1.023552905575332,1003,5964,0,0,0,0,1
1339,1.023552905575332,2851,4190,0,0,0,0,1
3161,1.023552905575332,2999,6160,0,0,0,0,1
3887,1.023552905575332,1549,5436,0,0,0,0,1
3202,1.023552905575332,2979,6181,0,0,0,0,1
1953,1.023552905575332,2527,4480,0,0,0,0,1
3843,1.023552905575332,1580,5423,0,0,0,0,1
4645,1.023552905575332,1207,5852,0,0,0,0,1
2476,1.023552905575332,2254,4730,0,0,0,0,1
1671,1.023552905575332,2668,4339,0,0,0,0,1
1406,1.023552905575332,2701,4107,0,0,0,0,1
3966,0.09742292061562696,1536,5502,0,0,0,0,1
4329,1.023552905575332,1352,5681,0,0,0,0,1
3188,1.023552905575332,2293,5481,0,0,0,0,1
4412,1.023552905575332,1298,5710,0,0,0,0,1
2561,0.08696759364904677,2222,4783,0,0,0,0,1
1513,1.023552905575332,2761,4274,0,0,0,0,1
1669,1.023552905575332,2680,4349,0,0,0,0,1
4253,1.023552905575332,1376,5629,0,0,0,0,1
3886,1.023552905575332,1550,5436,0,0,0,0,1
3807,0.0568535434035207,1596,5403,0,0,0,0,1
3229,0.07673067984868198,2273,5502,0,0,0,0,1
4412,1.023552905575332,1299,5711,0,0,0,0,1
2358,1.023552905575332,2331,4689,0,0,0,0,1
4574,1.023552905575332,1213,5787,0,0,0,0,1
1556,1.023552905575332,2763,4319,0,0,0,0,1
4674,0.07948548207377178,1630,6304,0,0,0,0,1
4993,1.023552905575332,949,5942,0,0,0,0,1
3981,1.023552905575332,1506,5487,0,0,0,0,1
2455,1.023552905575332,2276,4731,0,0,0,0,1
4226,1.023552905575332,1384,5610,0,0,0,0,1
1366,1.023552905575332,2824,4190,0,0,0,0,1
3147,16.826727652701162,1629,4776,0,0,0,0,1
3984,34.62000707288312,1517,5501,0,0,0,0,1
3188,0.07281584260600414,1595,4783,0,0,0,0,1
3988,1.023552905575332,1509,5497,0,0,0,0,1
3166,1.023552905575332,2315,5481,0,0,0,0,1
2454,1.023552905575332,2277,4731,0,0,0,0,1
3988,1.023552905575332,1510,5498,0,0,0,0,1
2027,0.03890136592876612,2461,4488,0,0,0,0,1
2549,1.023552905575332,2218,4767,0,0,0,0,1
4478,1.023552905575332,1274,5752,0,0,0,0,1
3212,19.00036324246433,2321,5533,0,0,0,0,1
3181,1.023552905575332,2252,5433,0,0,0,0,1
1383,1.023552905575332,2783,4166,0,0,0,0,1
3839,1.023552905575332,1594,5433,0,0,0,0,1
3884,1.023552905575332,1552,5436,0,0,0,0,1
1950,1.023552905575332,2530,4480,0,0,0,0,1
2150,1.023552905575332,2432,4582,0,0,0,0,1
3839,1.023552905575332,1595,5434,0,0,0,0,1
3843,1.023552905575332,1587,5430,0,0,0,0,1
4608,1.023552905575332,1214,5822,0,0,0,0,1
4978,1.023552905575332,986,5964,0,0,0,0,1
2394,0.09591932986420029,2322,4716,0,0,0,0,1
3185,1.023552905575332,2296,5481,0,0,0,0,1
3152,1.023552905575332,2256,5408,0,0,0,0,1
4001,22.82560535044809,1509,5510,0,0,0,0,1
4133,15.047431271091542,1675,5808,0,0,0,0,1
1510,1.023552905575332,2764,4274,0,0,0,0,1
3228,108130.97032978285,2265,5493,0,0,0,0,1
1674,1.023552905575332,2667,4341,0,0,0,0,1
2482,1.023552905575332,2249,4731,0,0,0,0,1
1366,1.023552905575332,2764,4130,0,0,0,0,1
1759,1.023552905575332,2635,4394,0,0,0,0,1
2522,1.023552905575332,2241,4763,0,0,0,0,1
1882,1.023552905575332,2572,4454,0,0,0,0,1
2127,1.023552905575332,2432,4559,0,0,0,0,1
1882,1.023552905575332,2573,4455,0,0,0,0,1
2528,21.520431930362655,2255,4783,0,0,0,0,1
4539,1.023552905575332,1242,5781,0,0,0,0,1
2411,1.023552905575332,2313,4724,0,0,0,0,1
3180,1.023552905575332,2975,6155,0,0,0,0,1
1717,1.023552905575332,2670,4387,0,0,0,0,1
2452,1.023552905575332,2279,4731,0,0,0,0,1
2288,1.023552905575332,2358,4646,0,0,0,0,1
4967,1.023552905575332,886,5853,0,0,0,0,1
4579,1.023552905575332,1234,5813,0,0,0,0,1
3989,1.023552905575332,1471,5460,0,0,0,0,1
1851,1.023552905575332,2569,4420,0,0,0,0,1
3178,1.023552905575332,1628,4806,0,0,0,0,1
4229,1.023552905575332,1383,5612,0,0,0,0,1
1851,1.023552905575332,2570,4421,0,0,0,0,1
1381,1.023552905575332,2785,4166,0,0,0,0,1
3158,10.943496694923017,2352,5510,0,0,0,0,1
4475,1.023552905575332,1276,5751,0,0,0,0,1
2228,28.83191500054898,2628,4856,0,0,0,0,1
2378,1.023552905575332,2308,4686,0,0,0,0,1
2065,1.023552905575332,2456,4521,0,0,0,0,1
3179,1.023552905575332,2255,5434,0,0,0,0,1
1815,1.023552905575332,2604,4419,0,0,0,0,1
1694,1.023552905575332,2670,4364,0,0,0,0,1
2031,0.06510998752633262,2460,4491,0,0,0,0,1
4598,1.023552905575332,1214,5812,0,0,0,0,1
1393,0.023880122518136346,2460,3853,0,0,0,0,1
3179,1.023552905575332,2288,5467,0,0,0,0,1
1983,1.023552905575332,2532,4515,0,0,0,0,1
3179,1.023552905575332,2289,5468,0,0,0,0,1
2030,0.0348291352393148,2461,4491,0,0,0,0,1
2516,1.023552905575332,2251,4767,0,0,0,0,1
1671,1.023552905575332,2670,4341,0,0,0,0,1
3842,1.023552905575332,1594,5436,0,0,0,0,1
2332,1.023552905575332,2223,4555,0,0,0,0,1
3846,1.023552905575332,1586,5432,0,0,0,0,1
3810,1.023552905575332,1587,5397,0,0,0,0,1
4709,10.660601077723017,1595,6304,0,0,0,0,1
1715,1.023552905575332,2672,4387,0,0,0,0,1
1403,1.023552905575332,2726,4129,0,0,0,0,1
2363,1.023552905575332,2325,4688,0,0,0,0,1
4954,1.023552905575332,927,5881,0,0,0,0,1
2481,1.023552905575332,2256,4737,0,0,0,0,1
4301,1.023552905575332,1340,5641,0,0,0,0,1
2363,1.023552905575332,2326,4689,0,0,0,0,1
1842,1.023552905575332,2602,4444,0,0,0,0,1
3900,10.881300502598105,1536,5436,0,0,0,0,1
1849,1.023552905575332,2572,4421,0,0,0,0,1
2449,1.023552905575332,2282,4731,0,0,0,0,1
3156,1.023552905575332,2322,5478,0,0,0,0,1
3181,1.023552905575332,1593,4774,0,0,0,0,1
3212,10.491953093494933,2223,5435,0,0,0,0,1
2495,0.05340268292932452,2255,4750,0,0,0,0,1
3945,13.107810785414493,1509,5454,0,0,0,0,1
2574,1.023552905575332,2223,4797,0,0,0,0,1
2130,1.023552905575332,2432,4562,0,0,0,0,1
3188,0.08974723084291447,1596,4784,0,0,0,0,1
2414,1.023552905575332,2313,4727,0,0,0,0,1
3181,1.023552905575332,1627,4808,0,0,0,0,1
4070,1.023552905575332,1468,5538,0,0,0,0,1
1371,1.023552905575332,2819,4190,0,0,0,0,1
2017,1.023552905575332,2501,4518,0,0,0,0,1
3167,1.023552905575332,2299,5466,0,0,0,0,1
4565,0.08139908560742504,1676,6241,0,0,0,0,1
1794,0.07614605331860251,3061,4855,0,0,0,0,1
3947,1.023552905575332,1546,5493,0,0,0,0,1
4049,0.0832108461824417,2255,6304,0,0,0,0,1
4521,1.023552905575332,1263,5784,0,0,0,0,1
4398,1.023552905575332,1308,5706,0,0,0,0,1
3956,1.023552905575332,1538,5494,0,0,0,0,1
1261,1.023552905575332,2881,4142,0,0,0,0,1
3182,1.023552905575332,2287,5469,0,0,0,0,1
3839,468.00890430861995,1596,5435,0,0,0,0,1
4944,1.023552905575332,927,5871,0,0,0,0,1
3204,1.023552905575332,2977,6181,0,0,0,0,1
4725,1.023552905575332,1158,5883,0,0,0,0,1
4689,1.023552905575332,1159,5848,0,0,0,0,1
4048,0.04433999231110934,2256,6304,0,0,0,0,1
4610,1.023552905575332,1205,5815,0,0,0,0,1
2030,1.023552905575332,2501,4531,0,0,0,0,1
2602,1.023552905575332,2196,4798,0,0,0,0,1
2521,1.023552905575332,2254,4775,0,0,0,0,1
2360,36.04177186236587,2329,4689,0,0,0,0,1
1880,1.023552905575332,2571,4451,0,0,0,0,1
1638,1.023552905575332,2703,4341,0,0,0,0,1
1558,1.023552905575332,2761,4319,0,0,0,0,1
3178,1.023552905575332,1596,4774,0,0,0,0,1
3179,1.023552905575332,1629,4808,0,0,0,0,1
4254,1.023552905575332,1375,5629,0,0,0,0,1
3123,1.023552905575332,2321,5444,0,0,0,0,1
1931,1.023552905575332,2525,4456,0,0,0,0,1
3983,1.023552905575332,1504,5487,0,0,0,0,1
3123,114297.96148023453,2322,5445,0,0,0,0,1
4541,1.023552905575332,1266,5807,0,0,0,0,1
4228,1.023552905575332,1382,5610,0,0,0,0,1
3945,1.023552905575332,1548,5493,0,0,0,0,1
3709,31.555767142169643,1629,5338,0,0,0,0,1
4612,1635.01176265604,1629,6241,0,0,0,0,1
3178,1.023552905575332,1630,4808,0,0,0,0,1
4509,1.023552905575332,1241,5750,0,0,0,0,1
2095,0.08260199195747328,2461,4556,0,0,0,0,1
4234,1.023552905575332,1378,5612,0,0,0,0,1
1816,1.023552905575332,2606,4422,0,0,0,0,1
4611,259.54236127276386,1630,6241,0,0,0,0,1
4644,1.023552905575332,1207,5851,0,0,0,0,1
2475,1.023552905575332,2254,4729,0,0,0,0,1
3201,1.023552905575332,2980,6181,0,0,0,0,1
4607,1.023552905575332,1208,5815,0,0,0,0,1
2475,1.023552905575332,2255,4730,0,0,0,0,1
3885,1.023552905575332,1550,5435,0,0,0,0,1
3806,0.038066484866777175,1596,5402,0,0,0,0,1
1951,1.023552905575332,2528,4479,0,0,0,0,1
4691,1.023552905575332,1169,5860,0,0,0,0,1
4411,1.023552905575332,1299,5710,0,0,0,0,1
4252,1.023552905575332,1377,5629,0,0,0,0,1
3923,14.77183713886099,1571,5494,0,0,0,0,1
4573,1.023552905575332,1213,5786,0,0,0,0,1
4023,1.023552905575332,1377,5400,0,0,0,0,1
3228,0.0594705136556297,2274,5502,0,0,0,0,1
1687,0.09388066693686871,3123,4810,0,0,0,0,1
4056,1.023552905575332,1482,5538,0,0,0,0,1
1555,1.023552905575332,2764,4319,0,0,0,0,1
1367,1.023552905575332,2762,4129,0,0,0,0,1
2129,1.023552905575332,2430,4559,0,0,0,0,1
4992,1.023552905575332,950,5942,0,0,0,0,1
4541,1.023552905575332,1240,5781,0,0,0,0,1
4034,1.023552905575332,1675,5709,0,0,0,0,1
4265,0.08265552564789037,1376,5641,0,0,0,0,1
1883,1.023552905575332,2571,4454,0,0,0,0,1
3146,24.026799876550754,1629,4775,0,0,0,0,1
4023,0.09427060963661535,1509,5532,0,0,0,0,1
1813,1.023552905575332,2609,4422,0,0,0,0,1
3202,10.985202344989222,2330,5532,0,0,0,0,1
3145,12.88954295679957,1630,4775,0,0,0,0,1
4477,1.023552905575332,1274,5751,0,0,0,0,1
3180,1.023552905575332,2252,5432,0,0,0,0,1
3211,39.26150124175073,2322,5533,0,0,0,0,1
3180,1.023552905575332,2253,5433,0,0,0,0,1
1382,1.023552905575332,2784,4166,0,0,0,0,1
3838,1.023552905575332,1595,5433,0,0,0,0,1
1985,1.023552905575332,2530,4515,0,0,0,0,1
4000,35.26105147136898,1509,5509,0,0,0,0,1
4132,15.173622810224321,1675,5807,0,0,0,0,1
4847,1.023552905575332,1094,5941,0,0,0,0,1
3179,0.07497948187382351,2330,5509,0,0,0,0,1
4000,18.373281653088267,1510,5510,0,0,0,0,1
4204,1.023552905575332,1404,5608,0,0,0,0,1
1673,1.023552905575332,2668,4341,0,0,0,0,1
2478,1.023552905575332,2254,4732,0,0,0,0,1
4332,0.06549517834496246,1308,5640,0,0,0,0,1
3188,0.07353393955080856,2322,5510,0,0,0,0,1
1881,1.023552905575332,2573,4454,0,0,0,0,1
4017,1.023552905575332,1468,5485,0,0,0,0,1
2287,1.023552905575332,2358,4645,0,0,0,0,1
3773,12.962550559987998,1630,5403,0,0,0,0,1
4966,1.023552905575332,887,5853,0,0,0,0,1
4995,1.023552905575332,949,5944,0,0,0,0,1
3157,12.0701140451401,2352,5509,0,0,0,0,1
3983,1.023552905575332,1506,5489,0,0,0,0,1
2576,1.023552905575332,2221,4797,0,0,0,0,1
4228,1.023552905575332,1384,5612,0,0,0,0,1
3214,26.555130484960735,2222,5436,0,0,0,0,1
1850,1.023552905575332,2571,4421,0,0,0,0,1
1693,1.023552905575332,2670,4363,0,0,0,0,1
3157,10.0557922207574,2353,5510,0,0,0,0,1
4072,1.023552905575332,1466,5538,0,0,0,0,1
4597,1.023552905575332,1214,5811,0,0,0,0,1
4053,1.023552905575332,1617,5670,0,0,0,0,1
1980,0.09657795179049758,2511,4491,0,0,0,0,1
2063,1.023552905575332,2457,4520,0,0,0,0,1
3177,1.023552905575332,2256,5433,0,0,0,0,1
3178,1.023552905575332,2289,5467,0,0,0,0,1
3176,1.023552905575332,2300,5476,0,0,0,0,1
1820,1.023552905575332,2601,4421,0,0,0,0,1
1391,0.04947662265292245,2461,3852,0,0,0,0,1
3958,0.023943222564284543,1536,5494,0,0,0,0,1
4004,1.023552905575332,1508,5512,0,0,0,0,1
3183,1.023552905575332,2252,5435,0,0,0,0,1
2553,0.05026132696283728,2222,4775,0,0,0,0,1
4366,1.023552905575332,1310,5676,0,0,0,0,1
4330,0.03609965242171082,1311,5641,0,0,0,0,1
3845,1.023552905575332,1586,5431,0,0,0,0,1
4727,1.023552905575332,1156,5883,0,0,0,0,1
2152,1.023552905575332,2432,4584,0,0,0,0,1
3841,1900.29356213736,1595,5436,0,0,0,0,1
3191,1.023552905575332,2288,5479,0,0,0,0,1
2362,1.023552905575332,2326,4688,0,0,0,0,1
2516,1.023552905575332,2256,4772,0,0,0,0,1
4014,1.023552905575332,1471,5485,0,0,0,0,1
1415,1.023552905575332,2692,4107,0,0,0,0,1
1884,1.023552905575332,2572,4456,0,0,0,0,1
1848,1.023552905575332,2573,4421,0,0,0,0,1
1640,1.023552905575332,2701,4341,0,0,0,0,1
3814,1.023552905575332,1584,5398,0,0,0,0,1
3180,1.023552905575332,1594,4774,0,0,0,0,1
1884,1.023552905575332,2573,4457,0,0,0,0,1
3976,20.01311843538526,1517,5493,0,0,0,0,1
2413,1.023552905575332,2313,4726,0,0,0,0,1
3180,0.010781057529430685,1595,4775,0,0,0,0,1
3182,1.023552905575332,2975,6157,0,0,0,0,1
3991,1.023552905575332,1471,5462,0,0,0,0,1
3897,0.07467991783587265,1596,5493,0,0,0,0,1
3180,1.023552905575332,1628,4808,0,0,0,0,1
4069,1.023552905575332,1469,5538,0,0,0,0,1
1853,1.023552905575332,2569,4422,0,0,0,0,1
3166,1.023552905575332,2300,5466,0,0,0,0,1
1697,1.023552905575332,2669,4366,0,0,0,0,1
3946,1.023552905575332,1546,5492,0,0,0,0,1
3181,1.023552905575332,2254,5435,0,0,0,0,1
3946,1.023552905575332,1547,5493,0,0,0,0,1
4477,1.023552905575332,1276,5753,0,0,0,0,1
4613,1.023552905575332,1628,6241,0,0,0,0,1
3912,1.023552905575332,1551,5463,0,0,0,0,1
4397,1.023552905575332,1308,5705,0,0,0,0,1
3181,0.009511007560785661,2255,5436,0,0,0,0,1
3181,1.023552905575332,2287,5468,0,0,0,0,1
1696,1.023552905575332,2670,4366,0,0,0,0,1
2586,22.336483832340463,2223,4809,0,0,0,0,1
4943,1.023552905575332,927,5870,0,0,0,0,1
2390,1.023552905575332,2314,4704,0,0,0,0,1
2067,1.023552905575332,2489,4556,0,0,0,0,1
3181,1.023552905575332,2288,5469,0,0,0,0,1
3878,1.023552905575332,1556,5434,0,0,0,0,1
4047,0.07143209718556423,2256,6303,0,0,0,0,1
2029,1.023552905575332,2501,4530,0,0,0,0,1
1985,1.023552905575332,2532,4517,0,0,0,0,1
4724,1.023552905575332,1159,5883,0,0,0,0,1
4609,1.023552905575332,1206,5815,0,0,0,0,1
4290,1.023552905575332,1341,5631,0,0,0,0,1
2231,1.023552905575332,2393,4624,0,0,0,0,1
4288,0.005855042030034984,1352,5640,0,0,0,0,1
1996,1.023552905575332,2494,4490,0,0,0,0,1
1751,1.023552905575332,2635,4386,0,0,0,0,1
4329,1.023552905575332,1350,5679,0,0,0,0,1
2520,1.023552905575332,2254,4774,0,0,0,0,1
2474,1.023552905575332,2282,4756,0,0,0,0,1
2034,1.023552905575332,2483,4517,0,0,0,0,1
2334,3255.0061592603547,2223,4557,0,0,0,0,1
3808,0.06517948461714852,1595,5403,0,0,0,0,1
4329,1.023552905575332,1351,5680,0,0,0,0,1
3848,1.023552905575332,1586,5434,0,0,0,0,1
2520,119.48048447938103,2255,4775,0,0,0,0,1
3812,1.023552905575332,1587,5399,0,0,0,0,1
2403,0.04720950801202471,2313,4716,0,0,0,0,1
2365,1.023552905575332,2325,4690,0,0,0,0,1
2483,1.023552905575332,2256,4739,0,0,0,0,1
3213,17.332961403046767,1596,4809,0,0,0,0,1
1844,1.023552905575332,2602,4446,0,0,0,0,1
3122,1.023552905575332,2322,5444,0,0,0,0,1
2369,1.023552905575332,2318,4687,0,0,0,0,1
4994,1.023552905575332,948,5942,0,0,0,0,1
4987,1.023552905575332,1011,5998,0,0,0,0,1
4664,1.023552905575332,1186,5850,0,0,0,0,1
3177,1.023552905575332,1630,4807,0,0,0,0,1
3158,1.023552905575332,2322,5480,0,0,0,0,1
3183,1.023552905575332,1593,4776,0,0,0,0,1
2308,1.023552905575332,2490,4798,0,0,0,0,1
2376,34.81257852056914,2321,4697,0,0,0,0,1
2576,1.023552905575332,2223,4799,0,0,0,0,1
1373,1.023552905575332,2818,4191,0,0,0,0,1
2460,10.79951707127745,2256,4716,0,0,0,0,1
2961,13.67660792996343,1596,4557,0,0,0,0,1
2019,1.023552905575332,2501,4520,0,0,0,0,1
3169,1.023552905575332,2299,5468,0,0,0,0,1
4034,1.023552905575332,1481,5515,0,0,0,0,1
4444,1.023552905575332,1276,5720,0,0,0,0,1
1666,1.023552905575332,2673,4339,0,0,0,0,1
2474,1.023552905575332,2255,4729,0,0,0,0,1
3148,10.643521795413301,2255,5403,0,0,0,0,1
2553,0.05750350852930287,2223,4776,0,0,0,0,1
1786,1.023552905575332,2607,4393,0,0,0,0,1
2067,1.023552905575332,2452,4519,0,0,0,0,1
4946,1.023552905575332,926,5872,0,0,0,0,1
4606,1.023552905575332,1209,5815,0,0,0,0,1
2151,1.023552905575332,2431,4582,0,0,0,0,1
4400,1.023552905575332,1308,5708,0,0,0,0,1
3227,0.09149447568010427,2274,5501,0,0,0,0,1
1686,0.05757110254716115,3123,4809,0,0,0,0,1
4946,1.023552905575332,927,5873,0,0,0,0,1
2473,1.023552905575332,2256,4729,0,0,0,0,1
4911,0.08823958198423616,672,5583,0,0,0,0,1
4608,1.023552905575332,1213,5821,0,0,0,0,1
4910,0.06876374581078122,673,5583,0,0,0,0,1
4375,1.023552905575332,1337,5712,0,0,0,0,1
2651,31.67671761449297,2158,4809,0,0,0,0,1
3180,4.0779537631342126e-05,1596,4776,0,0,0,0,1
3181,0.00030530918993943373,1629,4810,0,0,0,0,1
4270,1.023552905575332,1340,5610,0,0,0,0,1
2411,1.023552905575332,2312,4723,0,0,0,0,1
3985,1.023552905575332,1504,5489,0,0,0,0,1
4230,1.023552905575332,1382,5612,0,0,0,0,1
2134,108.40983095739833,2460,4594,0,0,0,0,1
4995,1.023552905575332,1009,6004,0,0,0,0,1
3180,0.00014434474011847004,1630,4810,0,0,0,0,1
4511,1.023552905575332,1241,5752,0,0,0,0,1
4995,1.023552905575332,1010,6005,0,0,0,0,1
2229,29.896063616893603,2627,4856,0,0,0,0,1
3179,1.023552905575332,2253,5432,0,0,0,0,1
1381,1.023552905575332,2784,4165,0,0,0,0,1
4398,1.023552905575332,1310,5708,0,0,0,0,1
2065,1.023552905575332,2455,4520,0,0,0,0,1
4534,1.023552905575332,1676,6210,0,0,0,0,1
3999,31.664615201403027,1510,5509,0,0,0,0,1
4203,1.023552905575332,1404,5607,0,0,0,0,1
2477,1.023552905575332,2254,4731,0,0,0,0,1
2035,1.023552905575332,2484,4519,0,0,0,0,1
4324,1.023552905575332,1339,5663,0,0,0,0,1
4845,1.023552905575332,1095,5940,0,0,0,0,1
2477,1.023552905575332,2255,4732,0,0,0,0,1
2154,1.023552905575332,2430,4584,0,0,0,0,1
3846,1.023552905575332,1584,5430,0,0,0,0,1
4025,1.023552905575332,1376,5401,0,0,0,0,1
4413,1.023552905575332,1299,5712,0,0,0,0,1
1403,1.023552905575332,2724,4127,0,0,0,0,1
2359,1.023552905575332,2331,4690,0,0,0,0,1
4290,1.023552905575332,1376,5666,0,0,0,0,1
3846,1.023552905575332,1585,5431,0,0,0,0,1
4025,165.61070310041478,1377,5402,0,0,0,0,1
4575,1.023552905575332,1213,5788,0,0,0,0,1
4981,1.023552905575332,984,5965,0,0,0,0,1
3772,14.297491272202514,1630,5402,0,0,0,0,1
1417,1.023552905575332,2690,4107,0,0,0,0,1
1513,1.023552905575332,2762,4275,0,0,0,0,1
1762,1.023552905575332,2632,4394,0,0,0,0,1
5100,1.023552905575332,962,6062,0,0,0,0,1
3982,1.023552905575332,1506,5488,0,0,0,0,1
2575,1.023552905575332,2221,4796,0,0,0,0,1
4994,1.023552905575332,950,5944,0,0,0,0,1
3213,15.036608134263451,2222,5435,0,0,0,0,1
3198,1.023552905575332,2301,5499,0,0,0,0,1
4036,1.023552905575332,1675,5711,0,0,0,0,1
3156,11.338668441436266,2353,5509,0,0,0,0,1
3982,1.023552905575332,1507,5489,0,0,0,0,1
1367,1.023552905575332,2824,4191,0,0,0,0,1
2575,1.023552905575332,2222,4797,0,0,0,0,1
3782,1.023552905575332,1619,5401,0,0,0,0,1
3985,15.975287784213979,1517,5502,0,0,0,0,1
1488,1.023552905575332,2791,4279,0,0,0,0,1
2017,1.023552905575332,2499,4516,0,0,0,0,1
4566,0.07690307943212041,1675,6241,0,0,0,0,1
3150,1.023552905575332,3010,6160,0,0,0,0,1
3176,1.023552905575332,2256,5432,0,0,0,0,1
3132,96067.93474882422,2313,5445,0,0,0,0,1
3914,1.023552905575332,1548,5462,0,0,0,0,1
2382,1.023552905575332,2305,4687,0,0,0,0,1
1819,1.023552905575332,2601,4420,0,0,0,0,1
3876,1.023552905575332,1560,5436,0,0,0,0,1
1392,1.023552905575332,2702,4094,0,0,0,0,1
4479,1.023552905575332,1274,5753,0,0,0,0,1
4322,1.023552905575332,1341,5663,0,0,0,0,1
4237,1.023552905575332,1374,5611,0,0,0,0,1
3175,1.023552905575332,2301,5476,0,0,0,0,1
2068,1.023552905575332,2453,4521,0,0,0,0,1
3182,1.023552905575332,2252,5434,0,0,0,0,1
3880,1.023552905575332,1553,5433,0,0,0,0,1
1946,1.023552905575332,2531,4477,0,0,0,0,1
1660,1.023552905575332,2680,4340,0,0,0,0,1
3182,1.023552905575332,2253,5435,0,0,0,0,1
2151,1.023552905575332,2432,4583,0,0,0,0,1
3840,110.25109269825887,1595,5435,0,0,0,0,1
3844,1.023552905575332,1587,5431,0,0,0,0,1
1987,1.023552905575332,2530,4517,0,0,0,0,1
4002,1.023552905575332,1509,5511,0,0,0,0,1
1751,1.023552905575332,2643,4394,0,0,0,0,1
3073,10.922303274886374,2314,5387,0,0,0,0,1
1511,1.023552905575332,2764,4275,0,0,0,0,1
4849,1.023552905575332,1094,5943,0,0,0,0,1
1998,1.023552905575332,2492,4490,0,0,0,0,1
4692,1.023552905575332,1161,5853,0,0,0,0,1
2471,0.09784078082132722,2313,4784,0,0,0,0,1
3189,0.004807882788156574,2256,5445,0,0,0,0,1
4002,1.023552905575332,1510,5512,0,0,0,0,1
2336,1.023552905575332,2221,4557,0,0,0,0,1
2523,1.023552905575332,2241,4764,0,0,0,0,1
2444,1.023552905575332,2287,4731,0,0,0,0,1
2521,1.023552905575332,2252,4773,0,0,0,0,1
1414,1.023552905575332,2693,4107,0,0,0,0,1
1883,1.023552905575332,2573,4456,0,0,0,0,1
3813,1.023552905575332,1585,5398,0,0,0,0,1
1839,1.023552905575332,2604,4443,0,0,0,0,1
2289,1.023552905575332,2358,4647,0,0,0,0,1
4580,1.023552905575332,1234,5814,0,0,0,0,1
4957,1.023552905575332,925,5882,0,0,0,0,1
2412,1.023552905575332,2314,4726,0,0,0,0,1
1931,1.023552905575332,2523,4454,0,0,0,0,1
1852,1.023552905575332,2569,4421,0,0,0,0,1
3179,1.023552905575332,1628,4807,0,0,0,0,1
3122,12.785933345546344,2313,5435,0,0,0,0,1
2381,1.023552905575332,2245,4626,0,0,0,0,1
2528,25.560100025716945,2256,4784,0,0,0,0,1
3210,1.023552905575332,2258,5468,0,0,0,0,1
3990,1.023552905575332,1472,5462,0,0,0,0,1
2415,13.047897797857555,2274,4689,0,0,0,0,1
2379,1.023552905575332,2307,4686,0,0,0,0,1
3165,1.023552905575332,2301,5466,0,0,0,0,1
3945,1.023552905575332,1547,5492,0,0,0,0,1
2578,1.023552905575332,2221,4799,0,0,0,0,1
3911,1.023552905575332,1551,5462,0,0,0,0,1
3180,0.0032519633818443344,2255,5435,0,0,0,0,1
1695,1.023552905575332,2670,4365,0,0,0,0,1
4476,1.023552905575332,1277,5753,0,0,0,0,1
4599,1.023552905575332,1214,5813,0,0,0,0,1
3992,32.488361466292766,1509,5501,0,0,0,0,1
3180,1.023552905575332,2288,5468,0,0,0,0,1
1822,1.023552905575332,2600,4422,0,0,0,0,1
3179,0.00978327911900257,2256,5435,0,0,0,0,1
4723,1.023552905575332,1159,5882,0,0,0,0,1
3877,1.023552905575332,1557,5434,0,0,0,0,1
3180,1.023552905575332,2289,5469,0,0,0,0,1
4846,1.023552905575332,1096,5942,0,0,0,0,1
3178,1.023552905575332,2300,5478,0,0,0,0,1
2118,1.023552905575332,2432,4550,0,0,0,0,1
2333,1509.740353422886,2223,4556,0,0,0,0,1
3807,0.04993125468017042,1595,5402,0,0,0,0,1
4328,1.023552905575332,1351,5679,0,0,0,0,1
3847,1.023552905575332,1586,5433,0,0,0,0,1
3811,1.023552905575332,1587,5398,0,0,0,0,1
1404,1.023552905575332,2726,4130,0,0,0,0,1
1920,1.023552905575332,2534,4454,0,0,0,0,1
2482,1.023552905575332,2256,4738,0,0,0,0,1
4695,1.023552905575332,1160,5855,0,0,0,0,1
1315,1.023552905575332,2850,4165,0,0,0,0,1
2438,14.44458935280271,2313,4751,0,0,0,0,1
2402,0.023417636887022936,2314,4716,0,0,0,0,1
3728,0.09569244108998273,1675,5403,0,0,0,0,1
2518,1.023552905575332,2256,4774,0,0,0,0,1
4016,1.023552905575332,1471,5487,0,0,0,0,1
1965,1.023552905575332,2525,4490,0,0,0,0,1
4663,1.023552905575332,1186,5849,0,0,0,0,1
3157,1.023552905575332,2322,5479,0,0,0,0,1
3149,14.592355080056118,2352,5501,0,0,0,0,1
4256,1.023552905575332,1383,5639,0,0,0,0,1
2307,1.023552905575332,2490,4797,0,0,0,0,1
3182,1.023552905575332,1594,4776,0,0,0,0,1
2575,1.023552905575332,2223,4798,0,0,0,0,1
3981,18.339488571727884,1520,5501,0,0,0,0,1
2131,1.023552905575332,2432,4563,0,0,0,0,1
4543,1.023552905575332,1242,5785,0,0,0,0,1
2375,16.033393826739776,2322,4697,0,0,0,0,1
2415,1.023552905575332,2313,4728,0,0,0,0,1
3182,1.023552905575332,1627,4809,0,0,0,0,1
3663,0.04624318968584629,1676,5339,0,0,0,0,1
1372,1.023552905575332,2819,4191,0,0,0,0,1
4231,1.023552905575332,1379,5610,0,0,0,0,1
2495,0.060035172166156524,2256,4751,0,0,0,0,1
4969,0.049346387549287836,672,5641,0,0,0,0,1
3878,1.023552905575332,1551,5429,0,0,0,0,1
3147,15.354932098079065,2255,5402,0,0,0,0,1
4443,1.023552905575332,1277,5720,0,0,0,0,1
3757,1.023552905575332,1618,5375,0,0,0,0,1
1785,1.023552905575332,2608,4393,0,0,0,0,1
4945,1.023552905575332,927,5872,0,0,0,0,1
3146,27.285041945075392,2256,5402,0,0,0,0,1
4292,1.023552905575332,1340,5632,0,0,0,0,1
2031,1.023552905575332,2501,4532,0,0,0,0,1
2233,1.023552905575332,2392,4625,0,0,0,0,1
1955,1.023552905575332,2525,4480,0,0,0,0,1
3980,1.023552905575332,1445,5425,0,0,0,0,1
3882,1.023552905575332,1578,5460,0,0,0,0,1
1753,1.023552905575332,2635,4388,0,0,0,0,1
4331,1.023552905575332,1350,5681,0,0,0,0,1
3190,1.023552905575332,2291,5481,0,0,0,0,1
2522,1.023552905575332,2254,4776,0,0,0,0,1
2476,1.023552905575332,2282,4758,0,0,0,0,1
2361,32.131583840467655,2329,4690,0,0,0,0,1
1955,1.023552905575332,2526,4481,0,0,0,0,1
2036,1.023552905575332,2483,4519,0,0,0,0,1
1515,1.023552905575332,2759,4274,0,0,0,0,1
1449,0.08643992856745564,2403,3852,0,0,0,0,1
3814,1.023552905575332,1587,5401,0,0,0,0,1
3979,1.023552905575332,1446,5425,0,0,0,0,1
3115,113.3718896174127,2330,5445,0,0,0,0,1
2405,1.023552905575332,2313,4718,0,0,0,0,1
2369,1.023552905575332,2314,4683,0,0,0,0,1
2650,27.79525442063879,2159,4809,0,0,0,0,1
2338,1.023552905575332,2245,4583,0,0,0,0,1
1360,1.023552905575332,2830,4190,0,0,0,0,1
4953,1.023552905575332,1011,5964,0,0,0,0,1
4269,1.023552905575332,1341,5610,0,0,0,0,1
3160,1.023552905575332,2321,5481,0,0,0,0,1
2371,1.023552905575332,2318,4689,0,0,0,0,1
2133,38.77062879185609,2460,4593,0,0,0,0,1
4996,1.023552905575332,948,5944,0,0,0,0,1
4544,1.023552905575332,1237,5781,0,0,0,0,1
3179,0.0003454114984269473,1630,4809,0,0,0,0,1
4510,1.023552905575332,1241,5751,0,0,0,0,1
4865,10.321050770622522,1376,6241,0,0,0,0,1
4994,1.023552905575332,1010,6004,0,0,0,0,1
2398,15.905867843111253,2158,4556,0,0,0,0,1
3991,1.023552905575332,1507,5498,0,0,0,0,1
2132,16.835630777715306,2461,4593,0,0,0,0,1
3709,17.924753488092026,1630,5339,0,0,0,0,1
4612,226.7298659517364,1630,6242,0,0,0,0,1
3878,1.023552905575332,1558,5436,0,0,0,0,1
4480,1.023552905575332,1271,5751,0,0,0,0,1
2070,1.023552905575332,2451,4521,0,0,0,0,1
1782,1.023552905575332,2611,4393,0,0,0,0,1
4480,1.023552905575332,1272,5752,0,0,0,0,1
1668,1.023552905575332,2673,4341,0,0,0,0,1
3877,1.023552905575332,1559,5436,0,0,0,0,1
2512,1.023552905575332,2254,4766,0,0,0,0,1
2476,1.023552905575332,2255,4731,0,0,0,0,1
1952,1.023552905575332,2528,4480,0,0,0,0,1
3226,1.023552905575332,2264,5490,0,0,0,0,1
4127,1.023552905575332,1444,5571,0,0,0,0,1
2153,1.023552905575332,2431,4584,0,0,0,0,1
3845,1.023552905575332,1585,5430,0,0,0,0,1
4406,1.023552905575332,1300,5706,0,0,0,0,1
4024,1.023552905575332,1377,5401,0,0,0,0,1
3964,1.023552905575332,1530,5494,0,0,0,0,1
3150,1.023552905575332,2288,5438,0,0,0,0,1
4170,21.32984823679536,1413,5583,0,0,0,0,1
1752,1.023552905575332,2641,4393,0,0,0,0,1
1756,1.023552905575332,2633,4389,0,0,0,0,1
1512,1.023552905575332,2762,4274,0,0,0,0,1
4295,1.023552905575332,1340,5635,0,0,0,0,1
5099,1.023552905575332,962,6061,0,0,0,0,1
2525,1.023552905575332,2239,4764,0,0,0,0,1
1368,1.023552905575332,2762,4130,0,0,0,0,1
4993,1.023552905575332,950,5943,0,0,0,0,1
2088,1.023552905575332,2432,4520,0,0,0,0,1
1404,1.023552905575332,2762,4166,0,0,0,0,1
2574,1.023552905575332,2222,4796,0,0,0,0,1
2368,32.262904659880135,2321,4689,0,0,0,0,1
1854,1.023552905575332,2567,4421,0,0,0,0,1
3399,10.457230754879145,1376,4775,0,0,0,0,1
4272,1.023552905575332,1340,5612,0,0,0,0,1
3131,1.023552905575332,2313,5444,0,0,0,0,1
3898,0.08276611024737228,1595,5493,0,0,0,0,1
2381,1.023552905575332,2305,4686,0,0,0,0,1
3203,10.125371652478488,2330,5533,0,0,0,0,1
3146,10.5547806420464,1630,4776,0,0,0,0,1
1393,1.023552905575332,2673,4066,0,0,0,0,1
3131,8099888.625792424,2314,5445,0,0,0,0,1
3179,0.03199542389246406,3062,6241,0,0,0,0,1
3835,1.023552905575332,1584,5419,0,0,0,0,1
3181,1.023552905575332,2253,5434,0,0,0,0,1
2587,28.86833875801012,2222,4809,0,0,0,0,1
1824,1.023552905575332,2598,4422,0,0,0,0,1
1986,1.023552905575332,2530,4516,0,0,0,0,1
3912,1.023552905575332,1550,5462,0,0,0,0,1
4725,1.023552905575332,1157,5882,0,0,0,0,1
4848,1.023552905575332,1094,5942,0,0,0,0,1
3180,0.06284499199431362,2330,5510,0,0,0,0,1
2470,0.09312771058659709,2313,4783,0,0,0,0,1
4001,1.023552905575332,1510,5511,0,0,0,0,1
4290,1.023552905575332,1339,5629,0,0,0,0,1
4205,1.023552905575332,1404,5609,0,0,0,0,1
1404,1.023552905575332,2702,4106,0,0,0,0,1
2479,1.023552905575332,2254,4733,0,0,0,0,1
2335,1.023552905575332,2221,4556,0,0,0,0,1
3964,0.09005490972854491,1537,5501,0,0,0,0,1
4333,0.0402513089829714,1308,5641,0,0,0,0,1
3205,1.023552905575332,2980,6185,0,0,0,0,1
4847,1.023552905575332,1095,5942,0,0,0,0,1
2335,165.88278181412664,2222,4557,0,0,0,0,1
3844,1.023552905575332,1592,5436,0,0,0,0,1
4027,1405.6160084997107,1376,5403,0,0,0,0,1
2520,1.023552905575332,2253,4773,0,0,0,0,1
1405,1.023552905575332,2724,4129,0,0,0,0,1
1917,1.023552905575332,2540,4457,0,0,0,0,1
4292,1.023552905575332,1376,5668,0,0,0,0,1
3238,12.668848890237923,2255,5493,0,0,0,0,1
3214,24.898125344133216,1595,4809,0,0,0,0,1
2380,1.023552905575332,2245,4625,0,0,0,0,1
3194,1.023552905575332,2286,5480,0,0,0,0,1
2527,54.59720099290826,2256,4783,0,0,0,0,1
4900,1.023552905575332,1071,5971,0,0,0,0,1
4545,1.023552905575332,1239,5784,0,0,0,0,1
3200,1.023552905575332,2300,5500,0,0,0,0,1
2577,1.023552905575332,2221,4798,0,0,0,0,1
2133,1.023552905575332,2430,4563,0,0,0,0,1
3200,1.023552905575332,2301,5501,0,0,0,0,1
2577,1.023552905575332,2222,4799,0,0,0,0,1
3784,1.023552905575332,1619,5403,0,0,0,0,1
2019,1.023552905575332,2499,4518,0,0,0,0,1
3991,34.523128637572746,1510,5501,0,0,0,0,1
2103,1.023552905575332,2460,4563,0,0,0,0,1
2384,1.023552905575332,2305,4689,0,0,0,0,1
1821,1.023552905575332,2601,4422,0,0,0,0,1
1392,0.04539407638474302,2461,3853,0,0,0,0,1
2546,1.023552905575332,2219,4765,0,0,0,0,1
3833,52.22761321308058,1603,5436,0,0,0,0,1
3184,1.023552905575332,2252,5436,0,0,0,0,1
3882,1.023552905575332,1553,5435,0,0,0,0,1
2554,0.038655707671333285,2222,4776,0,0,0,0,1
4367,1.023552905575332,1310,5677,0,0,0,0,1
1948,1.023552905575332,2531,4479,0,0,0,0,1
1787,1.023552905575332,2606,4393,0,0,0,0,1
3219,10.518845412715201,2314,5533,0,0,0,0,1
2070,1.023552905575332,2486,4556,0,0,0,0,1
4292,1.023552905575332,1349,5641,0,0,0,0,1
2354,1.023552905575332,2335,4689,0,0,0,0,1
2437,17.35437138149549,2313,4750,0,0,0,0,1
3206,1.023552905575332,2975,6181,0,0,0,0,1
4004,1.023552905575332,1509,5513,0,0,0,0,1
2032,1.023552905575332,2499,4531,0,0,0,0,1
2517,1.023552905575332,2256,4773,0,0,0,0,1
4694,1.023552905575332,1161,5855,0,0,0,0,1
4015,1.023552905575332,1471,5486,0,0,0,0,1
2437,15.146842240522002,2314,4751,0,0,0,0,1
2604,1.023552905575332,2194,4798,0,0,0,0,1
4293,1.023552905575332,1339,5632,0,0,0,0,1
1964,1.023552905575332,2526,4490,0,0,0,0,1
3148,19.0363760050058,2353,5501,0,0,0,0,1
3977,27.283819668632567,1517,5494,0,0,0,0,1
1841,1.023552905575332,2604,4445,0,0,0,0,1
3181,0.0026980930071473404,1595,4776,0,0,0,0,1
2291,1.023552905575332,2358,4649,0,0,0,0,1
3662,0.08220081570910596,1676,5338,0,0,0,0,1
2494,0.02850571026698724,2256,4750,0,0,0,0,1
4582,1.023552905575332,1234,5816,0,0,0,0,1
4867,1.023552905575332,1071,5938,0,0,0,0,1
1933,1.023552905575332,2523,4456,0,0,0,0,1
3898,0.10031392139105763,1596,5494,0,0,0,0,1
3181,1.023552905575332,1628,4809,0,0,0,0,1
3203,1.023552905575332,2299,5502,0,0,0,0,1
3244,192.61263700700212,2265,5509,0,0,0,0,1
4968,0.02497823405607557,672,5640,0,0,0,0,1
3913,1.023552905575332,1551,5464,0,0,0,0,1
1493,1.023552905575332,2758,4251,0,0,0,0,1
2587,13.194401945390291,2223,4810,0,0,0,0,1
4967,0.02366453616277465,673,5640,0,0,0,0,1
4601,1.023552905575332,1214,5815,0,0,0,0,1
3879,1.023552905575332,1556,5435,0,0,0,0,1
2232,1.023552905575332,2392,4624,0,0,0,0,1
4204,1.023552905575332,1403,5607,0,0,0,0,1
3800,0.08572978647187122,1603,5403,0,0,0,0,1
4291,1.023552905575332,1341,5632,0,0,0,0,1
2232,1.023552905575332,2393,4625,0,0,0,0,1
4289,0.0011112838750550098,1352,5641,0,0,0,0,1
4370,1.023552905575332,1309,5679,0,0,0,0,1
1954,1.023552905575332,2526,4480,0,0,0,0,1
2513,1.023552905575332,2252,4765,0,0,0,0,1
2477,1.023552905575332,2253,4730,0,0,0,0,1
4330,1.023552905575332,1351,5681,0,0,0,0,1
4018,1.023552905575332,1405,5423,0,0,0,0,1
2521,536.2877355558476,2255,4776,0,0,0,0,1
3978,1.023552905575332,1446,5424,0,0,0,0,1
3813,1.023552905575332,1587,5400,0,0,0,0,1
1514,1.023552905575332,2760,4274,0,0,0,0,1
2404,0.05657314023797769,2313,4717,0,0,0,0,1
1922,1.023552905575332,2534,4456,0,0,0,0,1
2484,1.023552905575332,2256,4740,0,0,0,0,1
3214,10.768868443331685,1596,4810,0,0,0,0,1
2404,1.023552905575332,2314,4718,0,0,0,0,1
1370,1.023552905575332,2760,4130,0,0,0,0,1
2370,1.023552905575332,2318,4688,0,0,0,0,1
2090,1.023552905575332,2430,4520,0,0,0,0,1
4988,1.023552905575332,1011,5999,0,0,0,0,1
4665,1.023552905575332,1186,5851,0,0,0,0,1
3287,10.792594648760025,2207,5494,0,0,0,0,1
3159,1.023552905575332,2322,5481,0,0,0,0,1
2373,1.023552905575332,2278,4651,0,0,0,0,1
3961,12.745422174163219,1377,5338,0,0,0,0,1
3708,17.270550932583483,1630,5338,0,0,0,0,1
2397,15.956049776558348,2159,4556,0,0,0,0,1
2344,1.023552905575332,2282,4626,0,0,0,0,1
3782,1.023552905575332,1618,5400,0,0,0,0,1
2698,0.0807160055879826,2158,4856,0,0,0,0,1
2060,1.023552905575332,2460,4520,0,0,0,0,1
4233,1.023552905575332,1379,5612,0,0,0,0,1
3154,1.023552905575332,3001,6155,0,0,0,0,1
4479,1.023552905575332,1272,5751,0,0,0,0,1
3132,1.023552905575332,2312,5444,0,0,0,0,1
3183,1.023552905575332,2251,5434,0,0,0,0,1
3880,1.023552905575332,1551,5431,0,0,0,0,1
3998,1.023552905575332,1508,5506,0,0,0,0,1
2068,1.023552905575332,2452,4520,0,0,0,0,1
3916,1.023552905575332,1551,5467,0,0,0,0,1
2152,1.023552905575332,2431,4583,0,0,0,0,1
4405,1.023552905575332,1300,5705,0,0,0,0,1
1460,1.023552905575332,2791,4251,0,0,0,0,1
1989,1.023552905575332,2499,4488,0,0,0,0,1
4126,1.023552905575332,1445,5571,0,0,0,0,1
2474,1.023552905575332,2256,4730,0,0,0,0,1
4059,0.09002305815705405,1377,5436,0,0,0,0,1
4405,1.023552905575332,1301,5706,0,0,0,0,1
3963,1.023552905575332,1531,5494,0,0,0,0,1
4169,35.524597616794594,1414,5583,0,0,0,0,1
2371,1.023552905575332,2280,4651,0,0,0,0,1
4294,1.023552905575332,1341,5635,0,0,0,0,1
2157,1.023552905575332,2427,4584,0,0,0,0,1
2087,1.023552905575332,2432,4519,0,0,0,0,1
2652,17.41028985491519,2158,4810,0,0,0,0,1
4674,0.05821558817564464,1629,6303,0,0,0,0,1
1405,1.023552905575332,2784,4189,0,0,0,0,1
3816,1.023552905575332,1587,5403,0,0,0,0,1
3238,1.023552905575332,2264,5502,0,0,0,0,1
2367,19.46584231224739,2322,4689,0,0,0,0,1
2407,1.023552905575332,2313,4720,0,0,0,0,1
3986,1.023552905575332,1503,5489,0,0,0,0,1
2340,1.023552905575332,2245,4585,0,0,0,0,1
1853,1.023552905575332,2568,4421,0,0,0,0,1
3398,13.767070493203063,1377,4775,0,0,0,0,1
2289,1.023552905575332,2357,4646,0,0,0,0,1
3865,0.054275201543773896,1570,5435,0,0,0,0,1
4271,1.023552905575332,1341,5612,0,0,0,0,1
3130,1.023552905575332,2314,5444,0,0,0,0,1
2544,1.023552905575332,2223,4767,0,0,0,0,1
2021,1.023552905575332,2497,4518,0,0,0,0,1
2384,19.638879036794535,2313,4697,0,0,0,0,1
2066,1.023552905575332,2455,4521,0,0,0,0,1
3951,1.023552905575332,1542,5493,0,0,0,0,1
4482,1.023552905575332,1271,5753,0,0,0,0,1
1781,1.023552905575332,2633,4414,0,0,0,0,1
3178,1.023552905575332,2298,5476,0,0,0,0,1
1403,1.023552905575332,2702,4105,0,0,0,0,1
2512,1.023552905575332,2251,4763,0,0,0,0,1
4325,1.023552905575332,1339,5664,0,0,0,0,1
4204,1.023552905575332,1405,5609,0,0,0,0,1
2478,1.023552905575332,2255,4733,0,0,0,0,1
3883,1.023552905575332,1551,5434,0,0,0,0,1
2334,100.94849135679812,2222,4556,0,0,0,0,1
3847,1.023552905575332,1584,5431,0,0,0,0,1
4026,98.4931924960687,1376,5402,0,0,0,0,1
1916,1.023552905575332,2540,4456,0,0,0,0,1
4129,1.023552905575332,1444,5573,0,0,0,0,1
4291,1.023552905575332,1376,5667,0,0,0,0,1
2442,1.023552905575332,2289,4731,0,0,0,0,1
3847,1.023552905575332,1585,5432,0,0,0,0,1
4026,3351.9932613112414,1377,5403,0,0,0,0,1
3152,1.023552905575332,2288,5440,0,0,0,0,1
3193,1.023552905575332,2286,5479,0,0,0,0,1
1514,1.023552905575332,2762,4276,0,0,0,0,1
4646,0.09704118706771515,1595,6241,0,0,0,0,1
2132,1.023552905575332,2430,4562,0,0,0,0,1
3199,1.023552905575332,2301,5500,0,0,0,0,1
4037,1.023552905575332,1675,5712,0,0,0,0,1
2576,1.023552905575332,2222,4798,0,0,0,0,1
1528,1.023552905575332,2761,4289,0,0,0,0,1
3783,1.023552905575332,1619,5402,0,0,0,0,1
2415,1.023552905575332,2311,4726,0,0,0,0,1
2961,10.523367774775647,1595,4556,0,0,0,0,1
3664,0.037039962558016025,1675,5339,0,0,0,0,1
3989,1.023552905575332,1503,5492,0,0,0,0,1
3949,1.023552905575332,1544,5493,0,0,0,0,1
1811,1.023552905575332,2610,4421,0,0,0,0,1
2415,1.023552905575332,2312,4727,0,0,0,0,1
2102,1.023552905575332,2460,4562,0,0,0,0,1
2383,1.023552905575332,2305,4688,0,0,0,0,1
3182,1.023552905575332,1626,4808,0,0,0,0,1
1393,1.023552905575332,2702,4095,0,0,0,0,1
1395,1.023552905575332,2673,4068,0,0,0,0,1
3832,20.929813939599242,1603,5435,0,0,0,0,1
4438,1.023552905575332,1276,5714,0,0,0,0,1
3881,1.023552905575332,1553,5434,0,0,0,0,1
1947,1.023552905575332,2531,4478,0,0,0,0,1
3837,1.023552905575332,1584,5421,0,0,0,0,1
3832,24.94459126430107,1604,5436,0,0,0,0,1
4999,1.023552905575332,1010,6009,0,0,0,0,1
1778,1.023552905575332,2636,4414,0,0,0,0,1
3183,1.023552905575332,2253,5436,0,0,0,0,1
4366,1.023552905575332,1311,5677,0,0,0,0,1
2353,1.023552905575332,2335,4688,0,0,0,0,1
4003,1.023552905575332,1509,5512,0,0,0,0,1
2632,0.09379403071073812,2223,4855,0,0,0,0,1
2392,1.023552905575332,2312,4704,0,0,0,0,1
2069,1.023552905575332,2487,4556,0,0,0,0,1
4850,1.023552905575332,1094,5944,0,0,0,0,1
2031,1.023552905575332,2499,4530,0,0,0,0,1
2436,16.200301411766386,2314,4750,0,0,0,0,1
4372,1.023552905575332,1307,5679,0,0,0,0,1
2515,1.023552905575332,2250,4765,0,0,0,0,1
2479,1.023552905575332,2251,4730,0,0,0,0,1
2031,1.023552905575332,2500,4531,0,0,0,0,1
1635,1.023552905575332,2702,4337,0,0,0,0,1
4207,1.023552905575332,1404,5611,0,0,0,0,1
2233,1.023552905575332,2391,4624,0,0,0,0,1
2522,1.023552905575332,2252,4774,0,0,0,0,1
3814,1.023552905575332,1585,5399,0,0,0,0,1
2522,1.023552905575332,2253,4775,0,0,0,0,1
1840,1.023552905575332,2604,4444,0,0,0,0,1
1755,1.023552905575332,2637,4392,0,0,0,0,1
2290,1.023552905575332,2358,4648,0,0,0,0,1
4294,1.023552905575332,1376,5670,0,0,0,0,1
4581,1.023552905575332,1234,5815,0,0,0,0,1
3986,1.023552905575332,1473,5459,0,0,0,0,1
4666,1.023552905575332,1184,5850,0,0,0,0,1
3202,1.023552905575332,2300,5502,0,0,0,0,1
3160,1.023552905575332,2320,5480,0,0,0,0,1
4428,1.023552905575332,1276,5704,0,0,0,0,1
4832,1.023552905575332,1109,5941,0,0,0,0,1
3993,19.521805579107916,1509,5502,0,0,0,0,1
2069,1.023552905575332,2460,4529,0,0,0,0,1
2021,1.023552905575332,2499,4520,0,0,0,0,1
3172,0.07281011394813945,2330,5502,0,0,0,0,1
2462,0.08105735531741974,2313,4775,0,0,0,0,1
3180,0.01265303997811763,2256,5436,0,0,0,0,1
2070,1.023552905575332,2449,4519,0,0,0,0,1
3799,0.08698290961470848,1603,5402,0,0,0,0,1
4802,1.023552905575332,1139,5941,0,0,0,0,1
2106,1.023552905575332,2449,4555,0,0,0,0,1
2066,1.023552905575332,2490,4556,0,0,0,0,1
2068,1.023552905575332,2461,4529,0,0,0,0,1
4007,1.023552905575332,1508,5515,0,0,0,0,1
4369,1.023552905575332,1310,5679,0,0,0,0,1
2512,1.023552905575332,2253,4765,0,0,0,0,1
2153,1.023552905575332,2429,4582,0,0,0,0,1
3881,1.023552905575332,1550,5431,0,0,0,0,1
2403,0.029133459567677947,2314,4717,0,0,0,0,1
4006,1.023552905575332,1509,5515,0,0,0,0,1
2519,2350.694020656185,2256,4775,0,0,0,0,1
4339,1.023552905575332,1340,5679,0,0,0,0,1
1638,1.023552905575332,2702,4340,0,0,0,0,1
3150,27.391703718349305,2352,5502,0,0,0,0,1
4257,1.023552905575332,1383,5640,0,0,0,0,1
1843,1.023552905575332,2603,4446,0,0,0,0,1
2372,1.023552905575332,2279,4651,0,0,0,0,1
2372,1.023552905575332,2311,4683,0,0,0,0,1
3982,10.784170695127264,1520,5502,0,0,0,0,1
2132,1.023552905575332,2432,4564,0,0,0,0,1
4544,1.023552905575332,1242,5786,0,0,0,0,1
2291,1.023552905575332,2355,4646,0,0,0,0,1
2697,0.06761834083797356,2158,4855,0,0,0,0,1
3183,1.023552905575332,1627,4810,0,0,0,0,1
1747,1.023552905575332,3061,4808,0,0,0,0,1
2697,0.045039329132157524,2159,4856,0,0,0,0,1
4227,39.3400857974203,1413,5640,0,0,0,0,1
2546,1.023552905575332,2221,4767,0,0,0,0,1
3203,12.120885640513011,2329,5532,0,0,0,0,1
4227,30.107081307219584,1414,5641,0,0,0,0,1
3180,0.0408638308464859,3061,6241,0,0,0,0,1
3997,1.023552905575332,1508,5505,0,0,0,0,1
4518,1.023552905575332,1264,5782,0,0,0,0,1
3155,1.023552905575332,3005,6160,0,0,0,0,1
3758,1.023552905575332,1618,5376,0,0,0,0,1
1988,1.023552905575332,2499,4487,0,0,0,0,1
4603,1.023552905575332,1214,5817,0,0,0,0,1
3180,1.023552905575332,2296,5476,0,0,0,0,1
3147,15.228973337677296,2256,5403,0,0,0,0,1
3996,1.023552905575332,1509,5505,0,0,0,0,1
2072,0.005366076138203361,2460,4532,0,0,0,0,1
2234,1.023552905575332,2392,4626,0,0,0,0,1
1665,1.023552905575332,2675,4340,0,0,0,0,1
4686,1.023552905575332,1161,5847,0,0,0,0,1
4206,1.023552905575332,1403,5609,0,0,0,0,1
3180,0.09482827667770975,2329,5509,0,0,0,0,1
2156,1.023552905575332,2427,4583,0,0,0,0,1
3885,1.023552905575332,1549,5434,0,0,0,0,1
1754,1.023552905575332,2635,4389,0,0,0,0,1
4326,1.023552905575332,1337,5663,0,0,0,0,1
1756,1.023552905575332,2638,4394,0,0,0,0,1
2156,1.023552905575332,2428,4584,0,0,0,0,1
1450,0.06715348154802363,2403,3853,0,0,0,0,1
3815,1.023552905575332,1587,5402,0,0,0,0,1
3237,1.023552905575332,2264,5501,0,0,0,0,1
1958,1.023552905575332,2530,4488,0,0,0,0,1
2406,1.023552905575332,2313,4719,0,0,0,0,1
2651,17.974668429414837,2159,4810,0,0,0,0,1
2328,1.023552905575332,2334,4662,0,0,0,0,1
2339,1.023552905575332,2245,4584,0,0,0,0,1
4376,1.023552905575332,1335,5711,0,0,0,0,1
2369,1.023552905575332,2282,4651,0,0,0,0,1
2406,1.023552905575332,2314,4720,0,0,0,0,1
4955,1.023552905575332,949,5904,0,0,0,0,1
4270,1.023552905575332,1341,5611,0,0,0,0,1
2372,1.023552905575332,2318,4690,0,0,0,0,1
3236,148902.80404369885,2265,5501,0,0,0,0,1
3963,16.20122235711716,1376,5339,0,0,0,0,1
2399,12.600679266804667,2158,4557,0,0,0,0,1
4224,1.023552905575332,1384,5608,0,0,0,0,1
3984,1.023552905575332,1505,5489,0,0,0,0,1
3905,1.023552905575332,1551,5456,0,0,0,0,1
2379,18.319639176084955,2321,4700,0,0,0,0,1
3784,1.023552905575332,1617,5401,0,0,0,0,1
2133,29.50884396503541,2461,4594,0,0,0,0,1
3190,1.023552905575332,1586,4776,0,0,0,0,1
1714,0.0985435972129286,3061,4775,0,0,0,0,1
4547,1.023552905575332,1242,5789,0,0,0,0,1
4073,1.023552905575332,1465,5538,0,0,0,0,1
2383,26.675722090541388,2314,4697,0,0,0,0,1
3950,1.023552905575332,1542,5492,0,0,0,0,1
1380,1.023552905575332,2811,4191,0,0,0,0,1
3134,1.023552905575332,2311,5445,0,0,0,0,1
3185,1.023552905575332,2250,5435,0,0,0,0,1
3950,1.023552905575332,1543,5493,0,0,0,0,1
3156,1.023552905575332,3001,6157,0,0,0,0,1
4481,1.023552905575332,1272,5753,0,0,0,0,1
1780,1.023552905575332,2634,4414,0,0,0,0,1
1948,1.023552905575332,2529,4477,0,0,0,0,1
3227,1.023552905575332,2264,5491,0,0,0,0,1
4128,1.023552905575332,1444,5572,0,0,0,0,1
2154,1.023552905575332,2431,4585,0,0,0,0,1
3882,1.023552905575332,1552,5434,0,0,0,0,1
4407,1.023552905575332,1300,5707,0,0,0,0,1
3151,1.023552905575332,2288,5439,0,0,0,0,1
4171,11.95367883672371,1413,5584,0,0,0,0,1
1753,1.023552905575332,2641,4394,0,0,0,0,1
4128,1.023552905575332,1445,5573,0,0,0,0,1
2476,1.023552905575332,2256,4732,0,0,0,0,1
4209,1.023552905575332,1402,5611,0,0,0,0,1
4694,1.023552905575332,1159,5853,0,0,0,0,1
4296,1.023552905575332,1340,5636,0,0,0,0,1
4980,1.023552905575332,1011,5991,0,0,0,0,1
2373,1.023552905575332,2280,4653,0,0,0,0,1
3977,1.023552905575332,1508,5485,0,0,0,0,1
1416,1.023552905575332,2691,4107,0,0,0,0,1
2089,1.023552905575332,2432,4521,0,0,0,0,1
2369,34.07204007529863,2321,4690,0,0,0,0,1
3890,0.09504805581845224,1603,5493,0,0,0,0,1
5021,1.023552905575332,1010,6031,0,0,0,0,1
1885,1.023552905575332,2571,4456,0,0,0,0,1
1407,1.023552905575332,2784,4191,0,0,0,0,1
3663,0.06879067984965262,1675,5338,0,0,0,0,1
3988,1.023552905575332,1503,5491,0,0,0,0,1
1810,1.023552905575332,2610,4420,0,0,0,0,1
1747,458.8190203496933,3062,4809,0,0,0,0,1
2414,1.023552905575332,2312,4726,0,0,0,0,1
3987,1.023552905575332,1471,5458,0,0,0,0,1
1394,1.023552905575332,2673,4067,0,0,0,0,1
4437,1.023552905575332,1276,5713,0,0,0,0,1
3180,0.02896684221507072,3062,6242,0,0,0,0,1
3177,1.023552905575332,2254,5431,0,0,0,0,1
3831,13.781059865281131,1604,5435,0,0,0,0,1
4998,1.023552905575332,1010,6008,0,0,0,0,1
1379,1.023552905575332,2785,4164,0,0,0,0,1
2312,0.04568837266627345,3124,5436,0,0,0,0,1
2588,14.593581466978117,2222,4810,0,0,0,0,1
4478,1.023552905575332,1275,5753,0,0,0,0,1
4601,1.023552905575332,1212,5813,0,0,0,0,1
4236,1.023552905575332,1375,5611,0,0,0,0,1
3159,1.023552905575332,3000,6159,0,0,0,0,1
2068,1.023552905575332,2488,4556,0,0,0,0,1
2514,1.023552905575332,2250,4764,0,0,0,0,1
3180,1.023552905575332,2298,5478,0,0,0,0,1
4206,1.023552905575332,1404,5610,0,0,0,0,1
3206,10.360963200075359,1570,4776,0,0,0,0,1
1405,1.023552905575332,2702,4107,0,0,0,0,1
2514,1.023552905575332,2251,4765,0,0,0,0,1
4327,1.023552905575332,1339,5666,0,0,0,0,1
3206,1.023552905575332,2980,6186,0,0,0,0,1
4206,1.023552905575332,1405,5611,0,0,0,0,1
4289,0.010652801270408695,1351,5640,0,0,0,0,1
3206,16.031583960177432,1603,4809,0,0,0,0,1
2521,1.023552905575332,2253,4774,0,0,0,0,1
2357,1.023552905575332,2332,4689,0,0,0,0,1
1651,10.58670541797414,3124,4775,0,0,0,0,1
1633,1.023552905575332,2703,4336,0,0,0,0,1
1397,1.023552905575332,2784,4181,0,0,0,0,1
4293,1.023552905575332,1376,5669,0,0,0,0,1
4578,1.023552905575332,1213,5791,0,0,0,0,1
3215,13.178747313304958,1595,4810,0,0,0,0,1
3195,1.023552905575332,2286,5481,0,0,0,0,1
3985,1.023552905575332,1473,5458,0,0,0,0,1
1760,1.023552905575332,2633,4393,0,0,0,0,1
4580,1.023552905575332,1235,5815,0,0,0,0,1
1845,1.023552905575332,2601,4446,0,0,0,0,1
4427,1.023552905575332,1276,5703,0,0,0,0,1
2374,1.023552905575332,2309,4683,0,0,0,0,1
2447,1.023552905575332,2282,4729,0,0,0,0,1
2134,1.023552905575332,2430,4564,0,0,0,0,1
4988,1.023552905575332,1010,5998,0,0,0,0,1
4665,1.023552905575332,1185,5850,0,0,0,0,1
1365,1.023552905575332,2825,4190,0,0,0,0,1
3201,1.023552905575332,2301,5502,0,0,0,0,1
3171,1.023552905575332,2297,5468,0,0,0,0,1
2376,16.634706904072374,2313,4689,0,0,0,0,1
3170,0.0021540189478024183,2265,5435,0,0,0,0,1
4635,1.023552905575332,1214,5849,0,0,0,0,1
3991,1.023552905575332,1503,5494,0,0,0,0,1
3992,18.9552646589521,1510,5502,0,0,0,0,1
1835,1.023552905575332,3029,4864,0,0,0,0,1
2104,1.023552905575332,2460,4564,0,0,0,0,1
3883,1.023552905575332,1553,5436,0,0,0,0,1
1949,1.023552905575332,2531,4480,0,0,0,0,1
3839,1.023552905575332,1584,5423,0,0,0,0,1
4519,1.023552905575332,1263,5782,0,0,0,0,1
4368,1.023552905575332,1311,5679,0,0,0,0,1
2355,1.023552905575332,2335,4690,0,0,0,0,1
4005,1.023552905575332,1509,5514,0,0,0,0,1
4005,1.023552905575332,1510,5515,0,0,0,0,1
1637,1.023552905575332,2702,4339,0,0,0,0,1
2483,1.023552905575332,2254,4737,0,0,0,0,1
3173,0.052347816247793076,1603,4776,0,0,0,0,1
2524,1.023552905575332,2252,4776,0,0,0,0,1
3149,39.264661448707315,2353,5502,0,0,0,0,1
4256,1.023552905575332,1384,5640,0,0,0,0,1
2124,1.023552905575332,2431,4555,0,0,0,0,1
1842,1.023552905575332,2604,4446,0,0,0,0,1
2371,1.023552905575332,2312,4683,0,0,0,0,1
4957,1.023552905575332,947,5904,0,0,0,0,1
1362,1.023552905575332,2828,4190,0,0,0,0,1
3177,1.023552905575332,1629,4806,0,0,0,0,1
2696,0.03620645404677357,2159,4855,0,0,0,0,1
3182,1.023552905575332,1628,4810,0,0,0,0,1
4955,1.023552905575332,1009,5964,0,0,0,0,1
3162,1.023552905575332,2319,5481,0,0,0,0,1
3245,109.89869632862245,2265,5510,0,0,0,0,1
4226,112.85499334709208,1414,5640,0,0,0,0,1
1494,1.023552905575332,2757,4251,0,0,0,0,1
2545,1.023552905575332,2222,4767,0,0,0,0,1
3154,1.023552905575332,3006,6160,0,0,0,0,1
4968,0.045004310138450646,673,5641,0,0,0,0,1
3154,15.743475973556919,1629,4783,0,0,0,0,1
3880,1.023552905575332,1556,5436,0,0,0,0,1
2071,0.009886233874276633,2460,4531,0,0,0,0,1
4721,1.023552905575332,1160,5881,0,0,0,0,1
2072,1.023552905575332,2449,4521,0,0,0,0,1
3995,1.023552905575332,1510,5505,0,0,0,0,1
4516,1.023552905575332,1266,5782,0,0,0,0,1
1950,1.023552905575332,2527,4477,0,0,0,0,1
4804,1.023552905575332,1139,5943,0,0,0,0,1
2108,1.023552905575332,2449,4557,0,0,0,0,1
2514,1.023552905575332,2252,4766,0,0,0,0,1
2070,0.0029548731139319704,2461,4531,0,0,0,0,1
3848,1.023552905575332,1583,5431,0,0,0,0,1
3850,1.023552905575332,1586,5436,0,0,0,0,1
4019,1.023552905575332,1405,5424,0,0,0,0,1
2155,1.023552905575332,2429,4584,0,0,0,0,1
1515,1.023552905575332,2760,4275,0,0,0,0,1
1449,0.10147675354940598,2404,3853,0,0,0,0,1
4375,1.023552905575332,1335,5710,0,0,0,0,1
2405,1.023552905575332,2314,4719,0,0,0,0,1
3180,0.06632198638522947,2939,6119,0,0,0,0,1
2448,1.023552905575332,2283,4731,0,0,0,0,1
2091,1.023552905575332,2430,4521,0,0,0,0,1
4341,1.023552905575332,1340,5681,0,0,0,0,1
3962,16.06131489141062,1376,5338,0,0,0,0,1
1725,1.023552905575332,2669,4394,0,0,0,0,1
3962,11.724697684653808,1377,5339,0,0,0,0,1
2398,11.560554517393152,2159,4557,0,0,0,0,1
1749,1.023552905575332,3060,4809,0,0,0,0,1
2378,10.783782395945668,2322,4700,0,0,0,0,1
2293,1.023552905575332,2355,4648,0,0,0,0,1
3783,1.023552905575332,1618,5401,0,0,0,0,1
2418,1.023552905575332,2313,4731,0,0,0,0,1
3985,15.642038075356613,1509,5494,0,0,0,0,1
3133,1.023552905575332,2311,5444,0,0,0,0,1
3151,1.023552905575332,3009,6160,0,0,0,0,1
3949,1.023552905575332,1543,5492,0,0,0,0,1
2546,1.023552905575332,2218,4764,0,0,0,0,1
3133,1.023552905575332,2312,5445,0,0,0,0,1
3184,1.023552905575332,2251,5435,0,0,0,0,1
4480,1.023552905575332,1273,5753,0,0,0,0,1
4520,1.023552905575332,1264,5784,0,0,0,0,1
3838,1.023552905575332,1583,5421,0,0,0,0,1
1779,1.023552905575332,2635,4414,0,0,0,0,1
3955,1.023552905575332,1539,5494,0,0,0,0,1
2069,1.023552905575332,2452,4521,0,0,0,0,1
1260,1.023552905575332,2882,4142,0,0,0,0,1
4402,1.023552905575332,1308,5710,0,0,0,0,1
1947,1.023552905575332,2530,4477,0,0,0,0,1
1990,1.023552905575332,2499,4489,0,0,0,0,1
4127,1.023552905575332,1445,5572,0,0,0,0,1
4688,1.023552905575332,1160,5848,0,0,0,0,1
3182,1.023552905575332,2296,5478,0,0,0,0,1
4406,1.023552905575332,1301,5707,0,0,0,0,1
4170,15.948075240544696,1414,5584,0,0,0,0,1
1752,1.023552905575332,2642,4394,0,0,0,0,1
4850,1.023552905575332,1093,5943,0,0,0,0,1
4208,1.023552905575332,1403,5611,0,0,0,0,1
3968,1.023552905575332,1524,5492,0,0,0,0,1
4295,1.023552905575332,1341,5636,0,0,0,0,1
4412,1.023552905575332,1297,5709,0,0,0,0,1
2359,23.19798291158633,2330,4689,0,0,0,0,1
4126,1.023552905575332,1446,5572,0,0,0,0,1
1756,1.023552905575332,2635,4391,0,0,0,0,1
1518,1.023552905575332,2759,4277,0,0,0,0,1
2337,1.023552905575332,2220,4557,0,0,0,0,1
3974,13.85294432287367,1520,5494,0,0,0,0,1
4675,0.04423676179286711,1629,6304,0,0,0,0,1
1879,1.023552905575332,2573,4452,0,0,0,0,1
4536,1.023552905575332,1242,5778,0,0,0,0,1
2368,18.83978187781193,2322,4690,0,0,0,0,1
3889,0.09977241308509946,1604,5493,0,0,0,0,1
2449,1.023552905575332,2279,4728,0,0,0,0,1
3399,13.570883209508343,1377,4776,0,0,0,0,1
2371,1.023552905575332,2282,4653,0,0,0,0,1
2408,1.023552905575332,2314,4722,0,0,0,0,1
3208,1.023552905575332,2228,5436,0,0,0,0,1
4429,1.023552905575332,1274,5703,0,0,0,0,1
4957,1.023552905575332,949,5906,0,0,0,0,1
3866,0.02897810517067972,1570,5436,0,0,0,0,1
4547,1.023552905575332,1237,5784,0,0,0,0,1
2382,1.023552905575332,2244,4626,0,0,0,0,1
3989,1.023552905575332,1508,5497,0,0,0,0,1
2311,0.08484055052175621,3124,5435,0,0,0,0,1
4549,1.023552905575332,1241,5790,0,0,0,0,1
3907,1.023552905575332,1551,5458,0,0,0,0,1
3865,0.060469494123998324,1571,5436,0,0,0,0,1
3786,1.023552905575332,1617,5403,0,0,0,0,1
3176,1.023552905575332,2255,5431,0,0,0,0,1
2062,1.023552905575332,2456,4518,0,0,0,0,1
2337,0.09379983341603375,2352,4689,0,0,0,0,1
2028,0.06395181207625172,2460,4488,0,0,0,0,1
4872,1.023552905575332,1099,5971,0,0,0,0,1
4600,1.023552905575332,1213,5813,0,0,0,0,1
3952,1.023552905575332,1542,5494,0,0,0,0,1
1823,1.023552905575332,2599,4422,0,0,0,0,1
3158,1.023552905575332,3001,6159,0,0,0,0,1
2513,1.023552905575332,2251,4764,0,0,0,0,1
3839,1.023552905575332,1593,5432,0,0,0,0,1
2517,1.023552905575332,2243,4760,0,0,0,0,1
3884,1.023552905575332,1551,5435,0,0,0,0,1
4369,1.023552905575332,1308,5677,0,0,0,0,1
2356,1.023552905575332,2332,4688,0,0,0,0,1
3229,1.023552905575332,2264,5493,0,0,0,0,1
3205,10.694681530618759,1604,4809,0,0,0,0,1
2519,1.023552905575332,2247,4766,0,0,0,0,1
3848,1.023552905575332,1585,5433,0,0,0,0,1
4409,1.023552905575332,1300,5709,0,0,0,0,1
1686,0.07843869431689156,3124,4810,0,0,0,0,1
3153,1.023552905575332,2288,5441,0,0,0,0,1
2356,1.023552905575332,2333,4689,0,0,0,0,1
1510,1.023552905575332,2763,4273,0,0,0,0,1
4951,1.023552905575332,927,5878,0,0,0,0,1
2478,1.023552905575332,2256,4734,0,0,0,0,1
1759,1.023552905575332,2633,4392,0,0,0,0,1
4298,1.023552905575332,1340,5638,0,0,0,0,1
4339,1.023552905575332,1338,5677,0,0,0,0,1
2446,1.023552905575332,2282,4728,0,0,0,0,1
4258,1.023552905575332,1382,5640,0,0,0,0,1
2962,13.831482879463726,1595,4557,0,0,0,0,1
2375,15.347994461497734,2314,4689,0,0,0,0,1
1812,1.023552905575332,2610,4422,0,0,0,0,1
4067,1.023552905575332,1468,5535,0,0,0,0,1
3183,1.023552905575332,1626,4809,0,0,0,0,1
3179,1.023552905575332,2254,5433,0,0,0,0,1
5000,1.023552905575332,1010,6010,0,0,0,0,1
3882,1.023552905575332,1554,5436,0,0,0,0,1
1984,1.023552905575332,2531,4515,0,0,0,0,1
4603,1.023552905575332,1212,5815,0,0,0,0,1
3836,1.023552905575332,1596,5432,0,0,0,0,1
2191,37.25483981486091,2403,4594,0,0,0,0,1
1947,1.023552905575332,2532,4479,0,0,0,0,1
2516,1.023552905575332,2250,4766,0,0,0,0,1
2480,1.023552905575332,2251,4731,0,0,0,0,1
2032,1.023552905575332,2500,4532,0,0,0,0,1
3182,1.023552905575332,2298,5480,0,0,0,0,1
4208,1.023552905575332,1404,5612,0,0,0,0,1
2234,1.023552905575332,2391,4625,0,0,0,0,1
4291,1.023552905575332,1350,5641,0,0,0,0,1
2326,1.023552905575332,2529,4855,0,0,0,0,1
2482,1.023552905575332,2254,4736,0,0,0,0,1
3172,0.07313140898520379,1603,4775,0,0,0,0,1
2520,1.023552905575332,2243,4763,0,0,0,0,1
3172,0.09029573108125633,1604,4776,0,0,0,0,1
2123,1.023552905575332,2431,4554,0,0,0,0,1
2523,1.023552905575332,2253,4776,0,0,0,0,1
1756,1.023552905575332,2637,4393,0,0,0,0,1
1635,1.023552905575332,2703,4338,0,0,0,0,1
1399,1.023552905575332,2784,4183,0,0,0,0,1
4380,0.09779192951802891,1311,5691,0,0,0,0,1
3178,1.023552905575332,2977,6155,0,0,0,0,1
3116,201.00715482819044,2329,5445,0,0,0,0,1
2406,1.023552905575332,2312,4718,0,0,0,0,1
4965,1.023552905575332,888,5853,0,0,0,0,1
3987,1.023552905575332,1473,5460,0,0,0,0,1
1361,1.023552905575332,2829,4190,0,0,0,0,1
2301,0.0891617779654468,2256,4557,0,0,0,0,1
3161,1.023552905575332,2320,5481,0,0,0,0,1
2372,1.023552905575332,2317,4689,0,0,0,0,1
4429,1.023552905575332,1276,5705,0,0,0,0,1
2376,1.023552905575332,2309,4685,0,0,0,0,1
4506,1.023552905575332,1241,5747,0,0,0,0,1
1692,1.023552905575332,2671,4363,0,0,0,0,1
4990,1.023552905575332,1010,6000,0,0,0,0,1
3785,1.023552905575332,1616,5401,0,0,0,0,1
2304,1.023552905575332,2358,4662,0,0,0,0,1
2062,1.023552905575332,2458,4520,0,0,0,0,1
2463,0.07317885122107629,2313,4776,0,0,0,0,1
2345,1.023552905575332,2306,4651,0,0,0,0,1
3133,0.09117347527061603,2321,5454,0,0,0,0,1
4515,1.023552905575332,1266,5781,0,0,0,0,1
3879,1.023552905575332,1557,5436,0,0,0,0,1
2324,1.023552905575332,2531,4855,0,0,0,0,1
4720,1.023552905575332,1161,5881,0,0,0,0,1
3957,0.02964832183785464,1537,5494,0,0,0,0,1
2107,1.023552905575332,2449,4556,0,0,0,0,1
2069,1.023552905575332,2461,4530,0,0,0,0,1
2513,1.023552905575332,2253,4766,0,0,0,0,1
2154,1.023552905575332,2429,4583,0,0,0,0,1
2323,1.023552905575332,2532,4855,0,0,0,0,1
4604,1.023552905575332,1209,5813,0,0,0,0,1
2520,20789.90226504235,2256,4776,0,0,0,0,1
4374,1.023552905575332,1336,5710,0,0,0,0,1
3886,1.023552905575332,1576,5462,0,0,0,0,1
1639,1.023552905575332,2702,4341,0,0,0,0,1
2447,1.023552905575332,2284,4731,0,0,0,0,1
2090,1.023552905575332,2431,4521,0,0,0,0,1
4373,1.023552905575332,1337,5710,0,0,0,0,1
3984,17.012630353726717,1509,5493,0,0,0,0,1
4959,1.023552905575332,947,5906,0,0,0,0,1
1748,1534.4615654485835,3061,4809,0,0,0,0,1
3984,13.941235690194208,1510,5494,0,0,0,0,1
4228,16.997433082696087,1413,5641,0,0,0,0,1
2096,0.07283271934394878,2460,4556,0,0,0,0,1
4273,1.023552905575332,1339,5612,0,0,0,0,1
3204,11.428886181868979,2329,5533,0,0,0,0,1
2059,1.023552905575332,2461,4520,0,0,0,0,1
3170,1.023552905575332,2301,5471,0,0,0,0,1
3181,0.03182089360616349,3061,6242,0,0,0,0,1
3954,1.023552905575332,1539,5493,0,0,0,0,1
1695,1.023552905575332,2671,4366,0,0,0,0,1
4874,1.023552905575332,1097,5971,0,0,0,0,1
4396,1.023552905575332,1310,5706,0,0,0,0,1
4604,1.023552905575332,1214,5818,0,0,0,0,1
3997,1.023552905575332,1509,5506,0,0,0,0,1
1666,1.023552905575332,2675,4341,0,0,0,0,1
5046,1.023552905575332,985,6031,0,0,0,0,1
4723,1.023552905575332,1160,5883,0,0,0,0,1
4687,1.023552905575332,1161,5848,0,0,0,0,1
2510,1.023552905575332,2256,4766,0,0,0,0,1
3884,1.023552905575332,1578,5462,0,0,0,0,1
3181,0.07499693442647097,2329,5510,0,0,0,0,1
4518,1.023552905575332,1266,5784,0,0,0,0,1
3886,1.023552905575332,1549,5435,0,0,0,0,1
3201,1.023552905575332,2979,6180,0,0,0,0,1
2033,1.023552905575332,2484,4517,0,0,0,0,1
4327,1.023552905575332,1337,5664,0,0,0,0,1
4021,1.023552905575332,1404,5425,0,0,0,0,1
1995,1.023552905575332,2496,4491,0,0,0,0,1
3924,15.75190279049097,1570,5494,0,0,0,0,1
2480,1.023552905575332,2253,4733,0,0,0,0,1
2038,1.023552905575332,2483,4521,0,0,0,0,1
3965,0.08246699769215372,1536,5501,0,0,0,0,1
4328,1.023552905575332,1352,5680,0,0,0,0,1
3141,10.62820409782316,2353,5494,0,0,0,0,1
3973,11.517969915873278,1520,5493,0,0,0,0,1
1878,1.023552905575332,2573,4451,0,0,0,0,1
1517,1.023552905575332,2760,4277,0,0,0,0,1
4028,1.023552905575332,1375,5403,0,0,0,0,1
2357,1.023552905575332,2331,4688,0,0,0,0,1
4700,1.023552905575332,1160,5860,0,0,0,0,1
4377,1.023552905575332,1335,5712,0,0,0,0,1
2370,1.023552905575332,2282,4652,0,0,0,0,1
4293,1.023552905575332,1375,5668,0,0,0,0,1
4673,0.09477429014463505,1630,6303,0,0,0,0,1
3178,1.023552905575332,2979,6157,0,0,0,0,1
4503,1.023552905575332,1250,5753,0,0,0,0,1
3237,91651.40690166157,2265,5502,0,0,0,0,1
4956,1.023552905575332,950,5906,0,0,0,0,1
3207,1.023552905575332,2261,5468,0,0,0,0,1
3906,1.023552905575332,1551,5457,0,0,0,0,1
2578,1.023552905575332,2220,4798,0,0,0,0,1
3864,0.08715355431036897,1571,5435,0,0,0,0,1
3785,1.023552905575332,1617,5402,0,0,0,0,1
3175,1.023552905575332,2255,5430,0,0,0,0,1
1365,1.023552905575332,2824,4189,0,0,0,0,1
2344,1.023552905575332,2304,4648,0,0,0,0,1
4069,1.023552905575332,1466,5535,0,0,0,0,1
4548,1.023552905575332,1242,5790,0,0,0,0,1
3942,1.023552905575332,1551,5493,0,0,0,0,1
3785,1.023552905575332,1618,5403,0,0,0,0,1
1486,1.023552905575332,2791,4277,0,0,0,0,1
2104,1.023552905575332,2459,4563,0,0,0,0,1
3211,14.491248820953656,2321,5532,0,0,0,0,1
